AABB - Associação Atlética  Banco do Brasil
AAE - Auxílio de Avaliação Educacional
AACD - Associação de Assistência à Criança Deficiente
AAFBB -  Associação dos Antigos Funcionários do Banco do Brasil
ABAC – Associação Brasileira  das Administradoras de Consórcio
ABAL - Associação Brasileira de Alumínio
ABAMEC - Associação dos Analistas do Mercado de Capitais
ABAP - Associação Brasileira de Agências de Publicidade
ABAR - Associação Brasileira de Agências de Regulação
ABAS - Associação dos Funcionários do Banespa  
ABASE - Associação Bahiana de Supermercados
ABAV - Associação Brasileira de Agências de Viagens
ABC - Associação Brasileira de Ciências
ABCFarma - Associação Brasileira do Comércio Farmacêutico
ABCR - Associação Brasileira das Concessionárias de Rodovias
ABCRED - Associação Brasileira de Entidades de Microcrédito
ABDeC - Associação Brasileira de Documentaristas e Curta-Metragistas
ABDER - Associação Brasileira dos Departamentos Estaduais de Estradas de Rodagem
ABDI - Agência Brasileira de Desenvolvimento Industrial
ABE - Associação Brasileira de Educação
ABEA - ASSOCIAÇÃO BRASILEIRA DE ENGENHEIROS DE ALIMENTOS
ABEA - ASSOCIAÇÃO BRASILEIRA DE ENSINO DE ARQUITETURA
ABEAD - Associação Brasileira de Estudo do Álcool e Outras Drogas
ABEAS - Associação Brasileira de Educação Agrícola Superior 
ABECS - Asosociação Brasileira das Empresas de Cartões de Crédito e Serviços
ABED - Assembléia Brasileira de Economistas Domésticos
ABEE - ASSOCIAÇÃO BRASILEIRA DE ENGENHEIROS ELETRICISTAS
ABEEF - Associação Brasileira de Estudantes de Engenharia Florestal
ABEF - Associação Brasileira dos Exportadores de Frango
ABEJA - Associação Beneficente Jesus Abandonado
ABEM - Associação Brasileira de Esclerose Múltipla
ABEMA - Associação Brasileira de Entidades Estaduais de Meio Ambiente 
ABENC - ASSOCIAÇÃO BRASILEIRA DE ENGENHEIROS CIVIS
ABENGE - ASSOCIAÇÃO BRASILEIRA DE ENSINO DE ENGENHARIA
ABEP - Associação Brasileira de Estudos Populacionais
ABEQ - ASSOCIAÇÃO BRASILEIRA DE ENGENHARIA QUÍMICA
ABERJE - Associação Brasileira de Comunicação Empresarial
ABERT - Associação Brasileira de Emissoras de Rédio e Televisão
ABES - Associação Brasileira de Engenharia Sanitária e Ambiental
ABES - Associação Brasileira das Empresas de Softwares
ABETI - ASSOCIAÇÃO BRASILEIRA DE ENSINO TÉCNICO INDUSTRIAL
ABEVD - Associação Brasileira de Empresas de Vendas Diretas
ABGF - Agência Brasileira Gestora de Fundos Garantidores e Garantias
ABI - Associação Brasileira de Imprensa
ABICALÇADOS  - Associação Brasileira das Indústria de Calçados
ABIH - Associação Brasileira de Indústria de Hotéis
ABIN - Agência Brasileira de Inteligência
ABINIA - ASSOCIAÇÃO DE ESTADOS IBERO-AMERICANOS PARA O DESENVOLVIMENTO DAS BIBLIOTECAS NACIONAIS DOS PAÍSES IBERO-AMERICANOS
ABIPEM – Associação Brasileira dos Institutos de Previdência Estaduais e Municipais
ABIT - Associação Brasileira da Indústria Têxtil
ABL - Academia Brasileira de Letras
ABMI - Associação Brasileira de Música Independente
ABMN - Associação Brasileira de Masters de Natação
ABN  - Academia Brasileira de Neurologia
ABNT - Associação Brasileira de Normas Técnicas
ABO - Associação Brasileira de Ouvidores
ABONG - Associação Brasileira das Organizações Não-Governamentais
ABPA - Associação Brasileira de Pesquisadores em Arte
ABPC - Associação Brasileira de Paralisia Cerebral
ABPD - Associação Brasileira de Produtores de Discos
ABPV - Associação Brasileira de Pavimentação
ABRABC - Associação Brasileira de Bebidas
ABRABIN - Associação Brasileira de Bingos
ABRACICLO - Associação Brasileira dos Fabricantes de Motocicletas, Ciclomotores, Motonetas.e.Bicicletas
ABRAIC - Associação Brasileira dos Analistas de Inteligência Competitiva
ABRAME - Associação Brasileira dos Magistrados Espíritas
ABRAMET - Associação Brasileira de Medicina de Tráfego
ABRANET - Associação Brasileira de Provedores de Acesso, Serviços e Informações da Rede Internet
ABRAPIA - Associação Brasileira Multiprofisisonal de Proteção à Infância e Adolescência
ABRAPP - Associação Brasileira das Entidades Fechadas de Previdência Privada
ABRAS - Associação Brasileira de Supermercados
ABRASCA - Associação Brasileira das Companhias Abertas
ABRASCE - Associação Brasileira de Shoppings Center
ABRASPE - Associação Brasileira das Autogestões em Saúde Patrocinada pelas Empresas
ABRAT — Associação Brasileira de Advogados Trabalhistas
ABRATI - Assoc Brasil. das Empresas de Transp Rodov Intermunic, Interest e Internacional de Passageiros
ABRP - Associação Brasileira de Relações Públicas
ABRH - Associação Brasileira de Recursos Humanos
ABTC - Associação Brasileira de Transportadores de Carga
ABTI - Associação Brasileira de Transportes Internacionais
ABTLP - Associação Brasileira de Transporte e Logística de Produtos Perigosos
AC - Acre
AC - Autoridades Certificadoras 
ACADEPOL - Academia de Polícia (RS)
ACB - Associação dos Cartunistas do Brasil
ACBB - Ação Comunitária Batista no Boqueirão
ACC - Autorização para Conduzir Ciclomotor
ACE-14 - Acordo de Complementação Econômica, entre o Brasil e a Argentina 
ACEMN - Associação Cearense Master de Natação
ACEPE  - Associação Comunitária de Educandos Pais e Educadores - (Curitiba-PR)
ACERP - Associação de Comunicação Educativa Roquette Pinto
ACM - Antonio Carlos Magalhães
ACNUR - Alto Comissariado das Nações Unidas para Refugiados
AÇOMINAS - Aço Minas Gerais S.A.
ACP - Associação Comercial do Pará
AC Raiz - Autoridade Certificadora Raiz
ACREFI - Associação Nacional das Instituições  de Crédito, Financiamento de Investimento
ACS - Agente Comunitário de Saúde
ACSP - Associação Comercial de São Paulo
ADA - Agência de Desenvolvimento da Amazônia
ADA - Amigos dos Amigos (Facção criminosa -RJ)
ADCT - Ato das  Disposições  Constitucionais Transitórias
ADEBE - Associação dos Deficientes de Boa Esperança
ADENE - Agência de Desenvolvimento do Nordeste
ADEPI - Associação de Defesa da Propriedade Intelectual
ADESG - Associação dos Diplomados da Escola Superior de Guerra
ADEVAL- Associação das Empresas Distribuidoras de Valores
ADVB - Associação dos Dirigentes de Vendas e Marketing do Brasil
AEA - Associação Brasileira de Engenharia Automotiva
AEB - Associação de Exportadores do Brasil
AEB - Associação de Comércio Exterior
AEBA - Associação dos Empregados do Basa
AENFER - Associação de Engenheiros Ferroviários
AET - Autorização Especial de Trânsito
AF - Adicional de Função (BB)
AFA-PR - Associação dos Funcionários Aposentados e Pensionistas do Banco do Brasil no Estado do Paraná
AFPS - Auditor-Fiscal da Previdência Social
AFRF - Auditor-Fiscal da Receita Federal
AFRMM - Adicional ao Frete para a Renovação da Marinha Mercante 
AGB - ASSOCIAÇÃO DOS GEÓGRAFOS BRASILEIROS
AGEF - Armazéns Gerais Ferroviários S.A
AGEPAN (MS) - Agência Estadual de Regulação dos Serviços Públicos do Estado de Mato Grosso do Sul
AGER (MT) - Agência Estadual de Regulação dos Serviços Públicos do Estado de Mato Grosso
AGERBA (BA) - Agência Estadual de Regulação de Serviços Públicos de Energia, Transportes e Comunicação da Bahia
AGERGS (RS) - Agência Estadual de Regulação dos Serviços Públicos Delegados do Rio Grande do Sul
AGR (GO) - Agência Goiana de Regulação, Controle e Fiscalização de Serviços Públicos
AGU - Advocacia Geral da União
AI - Ato Institucional
AICE - Acesso Individual Classe Especial (Telefonia)
AID - Agência para o Desenvolvimento Internacional
AIDS - Síndrome da Imunodeficiência Adquirida
AIEA - Agência Internacional de Energia Atômica
AIH - Autorização de Internamento Hospitalar
AIMEX – Associação das Empresas Exportadoras de Madeira do Pará
AITP - Adicional de Indenização do Trabalhador Portuário Avulso
AIV - Autorização Interna de Viagem
AJD - Associação Juízes para a Democracia
AJUFE - Associação dos Juízes Federais
AJURIS - Associação dos Juízes do Rio Grande do Sul
AL - Assembléia Legislativa
ALADI - Associação Latino-Americana de Integração
ALCA - Área de Livre Comércio das Américas
ALCMS - Área de Livre Comércio de Macapá e Santana
ALCP - Área de Livre Comércio de  Pacaraima
ALN - Ação Libertadora Nacional
ALSHOP - Associação dos Lojistas de Shopping
AM - Amazonas
AMAB - Associação dos Magistrados da Bahia
AMAERJ - Associação dos Magistrados do Rio de Janeiro
AMAGES - Associação dos Magistrados do Espírito Santo
AMAGIS - Associação dos Magistrados Mineiros 
AMAMSUL - Associação dos Magistrados do Mato Grosso do Sul 
AMAN - Academia Militar das Agulhas Negras  
AMAPAR - Associação dos Magistrados do Paraná
AMATRA V - Associação dos Magistrados Trabalhistas da 5ª Região 
AMB - Associação dos Magistrados Brasileiros
AMB - Associação Médica Brasileira
AMC - Associação dos Magistrados Catarinenses
AMD - Autorização para Menor Desacompanhado 
AME - Assistência Médica de Emergência
AME - Associação Médico-Espírita do Brasil
AMEPA - Associação dos Magistrados do Pará 
AMMA - Associação dos Magistrados do Maranhão
AMPB - Associação dos Magistrados da Paraíba 
AMPEP - Associação do Ministério Público do Estado do Pará
AMUT - Associação de Municípios da Transamazônica, Santarém, Cuiabá e Oeste do Xingu
ANA - Agência Nacional de Águas
ANABB - Associação Nacional dos Funcionários do Banco do Brasil
ANAC - Agência Nacional de Aviação Civil
ANAMACO - Associação Nacional dos Comerciantes de Material de Construção
ANAMAGES - Associação Nacional dos Magistrados Estaduais 
ANAMATRA - Associação Nacional dos Magistrados da Justiça do Trabalho
ANAMMA - Associação Nacional dos Municípios e Meio Ambiente
ANAPP - Associação Nacional das Empresas de Previdência Privada
ANASPS - Associação Nacional dos Servidores da Previdência Social
ANATEL - Agência Nacional de Telecomunicações
ANATER - Agência Nacional de Assistência Técnica e Extensão Rural
ANBID - Associação Nacional dos Bancos de Investimentos
ANCINAVE - Agência Nacional do Cinema e do Audiovisual
ANCINE - Agência Nacional do Cinema
ANCOR - Associação Nacional das Corretoras de Valores
ANCOSOL - Associação Nacional de Cooperativas de Crédito e Economia Solidária
ANDES -  Sindicato Nacional dos Docentes do Ensino Superior
ANDES - Associação Nacional dos Desembargadores
ANDIFES - Associação Nacional dos Dirigentes das Instituições Federais de Ensino Superior
ANDIMA - Associação Nacional das Instituições do Mercado Aberto
ANEEL - Agência Nacional de Energia Elétrica
ANEFAC - Associação Nacional dos Executivos de Finanças, Administração e Contabilidade
ANEF - Associação Nacional das Empresas Financeiras de Montadoras
ANEL -Agência Nacional de Energia Elétrica
ANER – Associação Nacional de Editores de Revistas
ANDIB - Associação Nacional dos Bancos de Investimentos
ANDPF - Associação Nacional dos Delegados de Polícia Federal
ANEFAC - AssociaçãoNacional dos Executivos de Finanças, Administração e Contabilidade
ANFAVEA – Associação Nacional dos Fabricantes de Veículos Automotores
ANFEAG - Associação Nacional dos Trabalhadores em Empresas de Autogestão e Participação Acionária
ANFIP - Associação Nacional do Fiscais Previdenciários
ANGELA - Sistema de Análise Gerencial de Arrecadação
ANIMEC - Associação Nacional de Investidores do Mercado de Capitais
ANJ - Associação Nacional de Jornais
ANOTER - Associação Nacional dos Órgãos de Terra
ANP - Associação Nacional do Petróleo
ANP - Academia Nacional de Polícia (Polícia Federal) 
ANPCA - Associação Nacional dos Proprietários e Comerciantes de Armas
ANPG - Associação Nacional de Pós-Graduandos
ANPPREV - Associação Nacional dos Procuradores Federais da Previdência Social
ANPR - Associação Nacional dos Procuradores da República
ANPREJ - Assosicação Nacional de Presidentes de Juntas Comerciais
ANPROTEC  - Associação Nacional de Entidades Promotoras de Empreendimentos Inovadores
ANS - Agência Nacional de Saúde 
ANS - Agência Nacional de Saúde Suplementar 
ANTAQ - Agência Nacional de Transportes Aquaviários
ANTEAG - Associação Nacional de Trabalhadores de Empresas de Autogestão
ANTF - Associação Nacional de Transporte Ferroviário
ANTT - Agência Nacional de Transportes Terrestres
ANVISA - Agência Nacional de Vigilância Sanitária
AOL - American On-line
AP - Ação Popular
AP - Assembléia Paraense ( Clube - Pa)
APA - Área de Proteção Ambiental
APABB - Associação de Pais e Amigos de Pessoas Portadoras de Deficiências dos Funcionários do Banco do Brasil
APADIC - Associação de Proteção e Assistência aos Direitos da Cidadania
APAE - Associação dos Pais e Amigos dos Excepcionais 
APCA - Associação Paulista de Críticos de Artes
APCF - Associação dos Peritos Criminais Federais
APDC - Associação de Plantio Direto no Cerrado
APEC - Agência Federal de Prevenção e Controle de Doenças  
APEX  - Agência de Promoção de Exportações
APEX-Brasil  - Agência de Promoção de Exportações do Brasil
APFUT - Autoridade Pública de Governança do Futebol 
APIMEC - Associação dos Analistas e Profissionais de Investimento do Mercado de Capitais
APM -  Associação Paulista de Medicina
APO - Autoridade Pública Olímpica
APP - Associação de Profissionais de Propaganda
APVAR - Associação dos Pilotos da Varig
AR - Aviso de Recebimento (Correios)
AR - Autoridades de Registro
ARCAL  - Acordo Regional de Cooperação para a Promoção da Ciência e da Tecnologia Nucleares na América Latina e no Caribe
ARCE (CE) - Agência Reguladora de Serviços Públicos Delegados do Estado do Ceará 
ARCON - Agência de Regulação de Controle de Serviço
ARCON (PA) - Agência Estadual de Regulação e Controle de Serviços Públicos
ARENA - Aliança Renovadora Nacional
ARF - Auditoria da Receita Federal ou Auditor da Receita Federal
ARPA - Áreas Protegidas da Amazônia
ARPE (PE) - Agência Reguladora de Serviços Públicos do Estado de Pernambuco
ARSAL (AL) - Agência Reguladora de Serviços Públicos do Estado de Alagoas
ARSAM (AM) - Agência Reguladora de Serviços Públicos do Estado do Amazonas
ARSEP (RN) - Agência Reguladora de Serviços Públicos do Rio Grande do Norte
ARTESP - Agência Reguladora dos Serviços Públicos Delegados de Transporte do Estado de São Paulo
ASAC – Associação Santarena de Agremiações Carnavalescas – (Santarém – PA)
ASBRAER - Associação Brasileira das Empresas de Extensão Rural
ASEP (RJ) - Agência Reguladora de Serviços Públicos Concedidos do Estado do Rio de Janeiro
ASFEPA - Associação dos Servidores do Fisco do Estado do Pará
ASES (SE) - Agência Reguladora de Serviços Concedidos do Estado de Sergipe
ASLOG - Associação Brasileira de Logística
ASMETO - Associação dos Magistrados do Tocantins
ASPAD - Associação de Pais e Amigos Down
ASPT - Ação Social da Paróquia de  Taquarituba/SP
ASSJT - Assistência Social de São Judas Tadeu
ATER - Assistência Técnica e Extensão Rural
ATP - Adicional de Tarifa Portuária
ATPF - Autorização para Transporte de Produtos Florestais (Atual DOF  - Documento de Origem Florestal)
ATR - Adicional Temporário de Revitalização (BB)
ATT - Associação dos Tripulantes da TAM
AVAO - Associação Voluntariado de Apoio à Oncologia  
AVC - Acidente Vascular Cerebral
BANESCOR – BANESPA S.A. Corretora de Câmbio e Títulos
BANESPA - Banco do Estado de São Paulo S.A
BANPARÁ - Banco do Estado do Pará
BB - Banco do Brasil
BBB - Big Brother Brasil (TV Globo)
BBCOOP - Cooperativa de Consumo dos Funcionários do Banco do Brasil no Estado de São Paulo
BC - Batalhão de Caçadores
BCB - Banco Central do Brasil
BCC - Batalhão de Carros de Combate
BDMG - Banco de Desenvolvimento de Minas Gerais
BEA - Banco do Estado do Amazonas S.A 
BEC - Banco do Estado do Ceará S. A.
BEG - Banco do Estado de Goiás S. A.
BEM - Banco do Estado do Maranhão S.A.
BEP - Banco do Estado do Piauí S.A
BESC - Banco do Estado de Santa Catarina S.A.  
BIB - Batalhão de Infantaria Blindada
BIB - Brazil Investment Bond
BID - Banco Interamericano de Desenvolvimento 
BIOAMAZÔNIA - Associação Brasileira para o Uso Sustentável da Biodiversidade da Amazônia
BIPSAM - Banco Interativo de Projetos Sociais da Amazônia
BIS - Batalhão de Infantaria da Selva
BM&F - Bolsa de Mercadorias e Futuros
BNCC - Banco Nacional de Crédito Cooperativo S.A.
BNDES - Banco Nacional de Desenvolvimento Econômico e Social
BOPE - Batalhão de Operações Especiais (PM do RJ)
BOVESPA - Bolsa de Valores do Estado de São Paulo
BOVMESB - Bolsa de Valores Minas-Espírito Santo-Brasília
BPM -  Batalhão da Polícia Militar
BTN - Bônus do Tesouro Nacional
BVRJ - Bolsa de Valores do Rio de Janeiro
CA - Cargos Comissionados de Assessoria
CAADJ  - Comissão para Análise da Aplicação de Decisões Judiciais  
CACB - Confederação das Associações Comerciais do Brasil
CACD  - Concurso de Admissão à Carreira de Diplomata
CACEX - Carteira de Comércio Exterior do Banco do Brasil S.A. 
CADE - Conselho Administrativo de Defesa Econômica
CAE - Curso de Altos Estudos
CADIN - Cadastro Informativo de Créditos não Quitados do Setor Público Federal 
CADMUT - Cadastro Nacional de Mutuários 
CADÚNICO - Cadastro Único para Programas Sociais
CADOC  - Catálogo de Documentos  (BC)
CAE - Conselho de Alimentação Escolar 
CAEEB  - Companhia Auxiliar de Empresas Elétricas Brasileiras
CAF - Comitê de Articulação Federativa
CAFA - Comissão de Alimentação das Forças Armadas
CAFIR - Cadastro de Imóveis Rurais
CAGED - Cadastro Geral de Empregados e Desempregados (Ministério do Trabalho)
CAIS\RNP - Centro de Atendimento e Incidentes de Segurança da Rede Nacional de Ensino e Pesquisa
CAMEX - Câmara de Comércio Exterior
CAP - Centro de Atendimento ao Público - (TJE/PA)
CAP - Curso de Atualização em Política Externa
CAPES - Coordenação de Aperfeiçoamento de Pessoal de Nível Superior
CAPs - Conselhos de Autoridade Portuária
CAR - Cadastro Ambiental Rural
CAS - Cargos Comissionados de Assistência
CASEMG - Companhia de Armazéns e Silos do Estado de Minas Gerais
CASSI - Caixa de Assistência dos Funcionários do Banco do Brasil
CAT - Comunicação de Acidente do Trabalho
C. At. - Conselho Atuarial (Previdência Social)
CBB - Confederação Brasileira de Basquete
CBB - Confederação Brasileira de Box
CBDA – Confederação Brasileira de Desportos Aquáticos
CBEE - Comercializadora Brasileira de Energia Emergencial
CBF - Confederação Brasileira de Futebol 
CBHPM - Classificação Brasileira Hierarquizada de Procedimentos Médicos
CBIC - Câmara Brasileira da Indústria da Construção Civil
CBM -  CENTRO DE BIOLOGIA DA MARINHA (São Sebastião)
CBTU - Companhia Brasileira de Trens Urbanos
CBJ - Confederação Brasileira de Judô
CBJP - Comissão Brasileira de Justiça e Paz
CBTF - Câmara Brasileira de Transporte Ferroviário
CBTU - Companhia Brasileira de Trens Urbanos
CC - Código Civil
CCBB - Centro Cultural Banco do Brasil
CCC - Central de Comutação e Controle
CCC - Comando de Caça aos Comunistas
CCC - Conta de Consumo de Combustíveis Fósseis
CCCCN - Comissão Coordenadora da Criação do Cavalo Nacional 
CCEAF - Comissão de Conservação de Energia na Administração Federal
CCEE - Câmara de Comercialização de Energia Elétrica
CCF – Cadastro de Emitentes de Cheques sem Fundos
CCFCVS - Conselho Curador do FCVS
CCFGTS - Curador do Fundo de Garantia do Tempo de Serviço
CCI - Cédula de Crédito Imobiliário
CCIR - Certificado de Cadastro do Imóvel Rural
CCJ - Comissão de Constituição,  Justiça e Cidadania (Senado)
CCM - Comissão de Comércio do Mercosul
CCNT - Centro de Ciências Naturais e Tecnologia
CCR - Companhia de Concessões Rodoviárias
CCS - Cadastro dee Clientes do Sistema Finnceiro Nacional
CCSS - Cargos Comissionados de Saúde Suplementar
CCT - Cargos Comissionados Técnicos
CCT - Conselho Nacional de Ciência e Tecnologia
CD- Direção de Instituição de Ensino
CD - Compact Disc
CDA - Certificado de Depósito Agropecuário 
CDAC - Conselho de Desenvolvimento do Agronegócio do Cacau
CDB - Certificado de Depósitos Bancários
CDC  - Conselho de Desenvolvimento Comercial
CDC - Companhia Docas do Ceará
CDCA - Certificado de Direitos Creditórios do Agronegócio 
CDDB - Conselho de Desenvolvimento do Desporto Brasileiro
CDDH - Centro de Defesa dos Direitos Humanos
CDDPH - Conselho de Defesa dos Direitos da Pessoa Humana
CDE - Conta de Desenvolvimento Energético
CDE - Carteira de Desenvolvimento Econômico
CDES - Conselho de Desenvolvimento Econômico e Social
CDFSB - Conselho Deliberativo do Fundo Soberano do Brasil
CDFMM - Conselho Diretor do Fundo da Marinha Mercante
CDHU - Cia de Desenvolvimento Habitacional e Urbano
CDL - Clube dos Diretores Lojistas
CDMA - Comissão para o Desenvolvimento dos Mercados Agrícolas
CDN - Conselho de Defesa Nacional
CDP - Companhia das Docas do Pará
CDPC - Deliberativo da Política do Café
CDRJ - Companhia Docas do Rio de Janeiro
CDRU - Concessão de Direito Real de Uso
CE - CHEQUE CORREIOS (Correios)
CEAGESP – Companhia de Entrepostos e Armazéns Gerais de São Paulo
CEAO - Centro de Estudos Afro Orientais (Bahia)
CEB - Conselho de Entidades de Base
CEBIMAR - CENTRO DE BIOLOGIA DA MARINHA (São Sebastião)
CEBRAE - Centro Brasileiro de Apoio à Pequena e Média Empresa
CEBRASPE - Centro Brasileiro de Pesquisa em Avaliação e Seleção e de Promoção de Eventos
CEDEC - Centro de Estudos de Cultura Contemporânea
CEDEC - Coordenadorias Estaduais de Defesa Civil
CEDUPI  - Certificado de Direito de Uso de Bem Público Imobiliário
CEF - Caixa Econômica Federal  
CEFET - Centro Federal de Educação Tecnológica
CEFET/PA  - Centro Federal de Educação Tecnológica do Pará
CEFET/PE - Centro Federal de Educação Tecnológica de Pernambuco
CEFET/RN - Centro Federal de Educação Tecnológica do Rio Grande do Norte
CEI - Comissão Especial Interministerial
CEITEC - Centro Nacional de Tecnologia Eletrônica Avançada S.A.
CEFET/SP - Centro Federal de Educação Tecnológica de São Paulo
CEITEC - Centro Nacional de Tecnologia Eletrônica Avançada S.A
CELESC - Centrais Elétricas de Santa Catarina
CELG  - Companhia Energética de Goiás
CELPA - Companhia Elétricas do Pará S.A
CELPE - Companhia Energética de Pernambuco
CELRM - Comissão de Estudos das Leis de Remuneração dos Militares das Forças Armadas
CEMAR  - Companhia Energética do Maranhão
C-EMOS - Curso de Estado-Maior para Oficiais Superiores
CEMPRE - Compromisso Empresarial para Reciclagem
CELTINS - Companhia de Energia Elétrica do Estado do Tocantins
CENA  - CENTRO DE ENERGIA NUCLEAR NA AGRICULTURA - Campus Luiz de Queiroz (Piracicaba)
CENP - Conselho Executivo das Normas-Padrão
CENSIPAM - Centro Gestor e Operacional do Sistema de Proteção da Amazônia
CEP - Comissão de Ética Pública
CEP - Código de Endereçamento Postal
CEPAI - Centro de Projetos e Assistência Integral 
CEPAL - Comissão Econômica para a América Latina e o Caribe
CEPAS - Companhia Especial de Polícia Assistencial (PM/PA)
CEPENE - Centro de Pesquisa e Gestão do Uso dos Recursos Pesqueiros do Litoral Nordeste
CEPLAC - Comissão Executiva do Plano da Lavoura Cacaueira
CEP - Código de Endereçamento Postal
CEP - Centro de Estudos de Pessoal
CEPENOR - Centro de Pesquisa e Gestão do Uso dos Recursos Pesqueiros do Litoral Norte 
CEPERG - Centro de Pesquisa e Gestão do Uso dos Recursos Pesqueiros Lagunares e Estuarinos
CEPNOR - Centro de Pesquisa e Gestão de Recursos Pesqueiros do Norte do Brasil
CEPSUL - Centro de Pesquisa e Gestão do Uso dos Recursos Pesqueiros do Litoral Sudeste e Sul
CER - Comissão Especial de Recursos
CERENU - Centro de Recuperação Nutricional (Pa) 
CES - Coeficiente de Equiparação Salarial
CESP - Companhia Energética de São Paulo
CESPE  - Centro de Seleção e Promoção de Eventos
CESVI -  Centro de Experimentação e Segurança Viária
CESUPA - Centro Universitário do Pará
CET  - Coeficiente de Equalização de Taxas
CET - Companhia de Engenharia de Tráfego
CEMIG - Companhia Energética de Minas Gerais
C-EMOS - Curso de Estado-Maior para Oficiais Superiores - Mestrado em Ciências Navais
CENIMAR - Centro de Informações da Marinha
CENP - Conselho Executivo das Normas-Padrão
CEPLAC - Comissão Executiva do Plano da Lavoura Cacaueira
CEPS  - Conselhos Estaduais de Previdência Social
CETEM  - Centro de Tecnologia Mineral
CETG - Cargos Especiais de Transição Governamental
CETIP - Central de Custódia e de Liquidação Financeira de Títulos
CETIP - Câmara de Custódia e Liquidação
CETRAN - Conselhos Estaduais de Trânsito
CEUAs - Comissões de Ética no Uso de Animais
CF - Constituição Federal
CFAS - Conselho Federal de Assistentes Sociais
CFBB - Conselho Federal de Biologia e Biomedicina
CFC - Centro de Formação de Condutores
CFDD - Conselho Federal Gestor do Fundo de Defesa de Direitos Difusos (Ministério da Justiça)
CFDD/BR - Conselho Federal dos Despachantes Documentalistas do Brasil 
CFED - Conselho Federal de Economistas Domésticos 
CFESS - Conselho Federal de Serviço Social
CFF - Conselho Federal de Fonoaudiologia
CFGE - Conselho Diretor do Fundo de Garantia à Exportação
CFIEx - Caixa de Financiamento Imobiliário do Exército
CFM - Conselho Federal de Medicina
CFMV - Conselho Federal de Medicina Veterinária
CFP - Companhia de Financiamento da Produção
CFPRP - Conselho Federal de Profissionais de Relações Públicas
CFT - Certificado Financeiro do Tesouro
CGC - Cadastro Geral do Contribuinte
CGCOM-SUL - Comitê Gestor de Acompanhamento de Compromissos Relativos à Integração Sul-americana
CGE - Cargos de Gerência Executiva
CGEN - Conselho de Gestão do Patrimônio Genético
CGI - Comissão Geral de Investigações
CGP - Comitê Gestor de Parceria Público-Privada Federal
CGPAC - Comitê Gestor do Programa de Aceleração do Crescimento
CGPAR - Comissão Interministerial de Governança Corporativa e de Administração de Participações Societárias da União
CGPC - Conselho de Gestão da Previdência Complementar
CGPD - Comitê Gestor de Políticas de Inclusão das Pessoas com Deficiência
CGP - Comitê Gestor de Parceria Público-Privada Federal
CGPAS - Comissão Gestora do Plano Amazônia Sustentável
CGPCB - Comitê Gestor do Projeto Casa Brasil
CGPID - Comitê Gestor do Programa de Inclusão Digital
CGPMAF - Coordenação-Geral de Polícia Marítima, Aeroportuária e de Fronteiras (Polícia Federal) 
CGRBT - Comitê Gestor de Articulação Institucional da Rede Brasil de Tecnologia
CGSIM - Comitê para Gestão da Rede Nacional para a Simplificação do Registro e da Legalização de Empresas e Negócios
CGSN - Comitê Gestor do Simples Nacional
CGT - Confederação Geral dos Trabalhadores
CGTB – Central Geral dos Trabalhadores do Brasil
CGTEE - Companhia de Geração Térmica de Energia Elétrica
CGU - Controladoria Geral da União
CHESF - Companhia Hidrelétrica do São Francisco
CHSE  - Curso de Habilitação para o Serviço Exterior
CIA - Agência Central de Inteligência - Central Intelligence Agency (EUA)
CIABA - Centro de Instrução Almirante Brás de Aguiar - Belém - Pa
CIAPO - Câmara Interministerial de Agroecologia e Produção Orgânica
CIASC - Centro de Instrução Almirante Sylvio de Camargo
CIAT - Centro Interamericano de Administrações Tributárias
CIBRAZEM - Companhia Brasileira de Armazenamento
CIC - Cartão de Identificação do Contribuinte
CID - Código Internacional de Doenças
CIDE - Contribuição de Intervenção sobre o Domínio Econômico
CIE - Centro de Informações do Exército
CIE - Carteira de Identidade de Estrangeiro
CIE - Carteira de Identificação Estudantil
CIEFAS - Comitê de Integração de Entidade Fechadas de Assistência à Saúde
CIG - Centro Integrado de Governo (Pará)
CIGA - Comitê Interministerial Governo Aberto
CII - Corporação Interamericana de Investimentos - CII
CIM - Comitê Interministerial sobre Mudança do Clima
CIMA - Conselho Interministerial do Açúcar e do Álcool 
CIMESPA - Cidade de Meninos São Paulo Apóstolo  
CIN - Centro Internacional de Negócios  
CIOP - Centro Integrado de Operações Policiais (PA)
CIPA - Comissão Interna de Prevenção de Acidentes
CIRM  - Comissão Interministerial para os Recursos do Mar 
CISA - Centro de Informações e Segurança da Aeronáutica
CISCOMIS - Comissão de Desenvolvimento do Projeto e da Implantação do Sistema de Comunicações Militares por Satélite
CITES -Comércio Internacional das Espécies Ameaçadas
CIVES - Associação dos Empresários pela Cidadania
CIVP - Convenção Internacional para a Proteção dos Vegetais
CJF - Conselho da Justiça Federal
CLAD - Centro Latino-Americano de Administração para o Desenvolvimento
CLAF - Centro Latino-Americano de Física
CLIA  - Centro Logístico e Industrial Aduaneiro
CLT - Consolidação das Leis do Trabalho
CMB - Casa da Moeda do Brasil
CMC - Conselho do Mercado Comum
CMC - Coordenadoria Municipal de Cultura - (Santarém-Pa)
CMCH  - Comissão de Coordenação das atividades de Meteorologia, Climatologia e Hidrologia
CMED - Câmara de Regulação do Mercado de Medicamentos
CMN - Conselho Monetário Nacional 
CMN - Centro de Medicina Nuclear
CMPS - Conselhos Municipais de Previdência Social
CMS - Carreira do Magistério Superior
CMSE - Comitê de Monitoramento do Setor Elétrico
CNA - Companhia Nacional de Abastecimento
CNA - Confederação Nacional da Agricultura
CNA - Companhia Nacional de Alcalis
CNAPO - Comissão Nacional de Agroecologia e Produção Orgânica
CNARQ - Conferência Nacional de Arquivos
CNAS - Conselho Nacional de Assistência Social
CNBB - Conferência Nacional dos Bispos do Brasil
CNBS - Conselho Nacional de Biossegurança
CNBioética - Comissão Nacional de Bioética em Saúde
CNC - Confederação Nacional do Comércio
CNC  - Consolidação das Normas Cambiais  (BC)
CNC 1  - Consolidação das Normas Cambiais - Contrato de Câmbio - (BC)
CNC 2  - Consolidação das Normas Cambiais - Mercado de Taxas Flutuantes - (BC)
CNC 5 - Consolidação das Normas Cambiais - Exportação - (BC)
CNCD - Conselho Nacional de Combate à Discriminação 
CNCMB - Comitê Nacional de Controle Higiênico-Sanitário de Moluscos Bivalves
CNDA - Conselho Nacional dos Direitos da Mulher
CNDI  - Conselho Nacional dos Direitos do Idoso
CNDI - Conselho Nacional de Desenvolvimento Industrial
CNDM  - Conselho Nacional dos Direitos da Mulher
CNDR - Conselho Nacional de Desenvolvimento Rural
CNDSS - Comissão Nacional sobre Determinantes Sociais da Saúde
CNDU - Conselho Nacional de Desenvolvimento Urbano
CNE - Conselho Nacional do Esporte
CNE - Conselho Nacional de Educação
CNEN - Comissão Nacional de Energia Nuclear (DEC.Nº 5.438 \ 29.04.2005)
CNES - Conselho Nacional de Economia Solidária
CNH - Carteira Nacional de Habilitação
CNI - Confederação Nacional da Indústria
CNIC - Comissão Nacional de Incentivo a Cultura
CNIF - Confederação Nacional das Instituições Financeiras
CNIS - Cadastro Nacional de Informações Sociais
CNJ -   Conselho Nacional da Juventude
CNJ -   Conselho Nacional de Justiça
CNPA - Conselho Nacional de Política Agrícola 
CNPC - Conselho Nacional de Previdência Complementar
CNPC - Conselho Nacional de Política Cultural
CNPCP - Conselho Nacional de Política Criminal e Penitenciária
CNPCT - Comitê Nacional de Prevenção e Combate à Tortura
CNPCT - Comitê Nacional para Prevenção e Controle da Tortura no Brasil
CNPCT - Comissão Nacional de Desenvolvimento Sustentável dos Povos e Comunidades Tradicionais
CNPE - Conselho Nacional de Política Energética
CNPGJ - Conselho Nacional dos Procuradores-Gerais de Justiça 
CNPI - Cadastro Nacional de Pessoas Físicas e Jurídicas Impedidas de Operar com os Fundos e Programas Habitacionais Públicos ou Geridos por Instituição Pública e com o Sistema Financeiro da Habitação
CNPIR - Conselho Nacional de Políticas de Promoção da Igualdade Racial
CNPJ - Cadastro Nacional de Pessoas Jurídica 
CNPq  - Conselho Nacional de Desenvolvimento Científico e Tecnológico
CNPS - Conselho Nacional de Previdência Social
CNRT - Conselho Nacional de Relações do Trabalho
CNS - Comitê Nacional de Saneamento
CNS - Conselho Nacional de Saúde
CNS - Confederação Nacional de Saúde, Hospitais, Estabelecimentos e Serviços
CNS - Confederação Nacional de Serviços 
CNSP - Conselho Nacional de Seguros Privados
CNT - Conselho Nacional do Trabalho
CNT - Confederação Nacional dos Transportes 
CNTE - Confederação Nacional dos Trabalhadores em Educação
CNTur - Conselho Nacional de Turismo
CNTur - Confederação Nacional do Turismo
CNVR - Cadastro Nacional de Veículos Roubados
COHAB - Companhias de Habitação Popular
COAF - Conselho de Controle de Atividades Financeiras
COALBRA -  Coque e Álcool da Madeira S.A. 
COB - Comitê Olímpico Brasileiro
COBAL - Companhia Brasileira de Alimentos
COBAE - Comissão Brasileira de Atividades Espaciais
COBAP - Confederação Brasileira de Aposentados e Pensionistas
COBRAMAB - Comissão Brasileira para o Programa “O Homem e a Biosfera”
COBRAPHI - Comissão Brasileira para Programas Hidrológicos Internacionais
COBRAPI - Companhia Brasileira de Projetos Industriais
COCAR - Comissão de Cartografia
CODAR - Codificação de Desastre, Ameaças e Riscos
CODARON - Companhia de Desenvolvimento Agrícola de Rondônia
CODEB - Cooperativa dos Evangélicos de Belém
CODEBA - Companhia das Docas do Estado da Bahia
CODEFAT - Conselho Deliberativo do Fundo de Amparo ao Trabalhador
CODERN - Companhia Docas do Rio Grande do Norte
CODERNAT - Comitê Brasileiro do Decênio Internacional para a Redução dos Desastres Naturais 
CODESA - Companhia Docas do Espírito Santo
CODESAIMA - Companhia de Desenvolvimento de Roraima 
CODESEI - Consórcio de Desenvolvimento Sócio-Econômico Intermunicipal
CODESP - Companhia Docas do Estado de São Paulo
CODEVASF - Companhia de Desenvolvimento dos Vales do São Francisco e do Parnaíba
CODI - Centro de Operações de Defesa Interna
CODIN - Companhia de Desenvolvimento Industrial - (Rio de Janeiro)
CODOMAR - Companhia Docas do Maranhão
COELBA - Companhia de Eletricidade do Estado da Bahia
COFA - Comitê Orientador do Fundo Amazônia
COFEN - Conselho Federal de Enfermagem
COFER  - Comissão Federal de Transportes Ferroviários
COFIEX - Comissão de Financiamentos Externos
COFIG - Comitê de Financiamento e Garantia das Exportações
COFINS - Contribuição para o Financiamento da Seguridade Social
COGEPOL - Corregedoria-Geral de Polícia (RS)
COGER  - Corregedoria-Geral da Receita Federal
COI - Comitê Olímpico Internacional
COIAB - Coordenação das Organizações Indígenas da Amazônia Brasileira
COLINA - Comando de Libertação Nacional
COMACE - Comitê de Avaliação de Créditos ao Exterior
COMAPA – Conselho de Mediação e Arbitragem do Estado do Pará
COMAR – Comando Aéreo Regional
COMARA - Comissão de Aeroportos da Região Amazônica
COMDEC - Coordenadorias Municipais de Defesa Civil 
COMICRO - Confederação Nacional das Microempresas e Empresas de Pequeno Porte
CONAB - Companhia Nacional de Abastecimento
CONABIO - Comissão Nacional de Biodiversidade
CONAC - Conselho de Aviação Civil 
CONACER - Comissão Nacional do Programa Cerrado Sustentável
CONAD - Conselho Nacional Antidrogas
CONADE - Conselho Nacional dos Direitos da Pessoa Portadora de Deficiência
CONAERO - Comissão Nacional de Autoridades Aeroportuárias
CONAES - Comissão Nacional de Avaliação da Educação Superior
CONAF - Congresso Nacional dos Auditores-Fiscais
CONAFLOR - Comissão Coordenadora do Programa Nacional de Florestas
CONAMA - Conselho Nacional de Meio-Ambiente
CONAMAT - Congresso Nacional dos Magistrados do Trabalho
CONAMP - Confederação Nacional do Ministério Público  
CONAMPE - Confederação Nacional das Micro e Pequenas Empresas e dos Empreendedores Individuais
CONANDA - Conselho Nacional dos Direitos da Criança e do Adolescente
CONANTAR - Comissão Nacional para Assuntos Antárticos
CONAPES - Comissão Nacional de Avaliação e Progresso do Ensino Superior
CONAQ - Comissão Nacional de Articulação das Comunidades Negras Rurais Quilombolas
CONARE - Comitê Nacional para os Refugiados
CONARQ - Conselho Nacional de Arquivos
CONASEMS - Conselho Nacional de Secretários Municipais de Saúde
CONASS - Conselho Nacional de Secretários de Saúde
CONASP - Conselho Nacional de Segurança Pública (MJ)
CONATRAE - Comissão Nacional de Erradicação do Trabalho Escravo
CONATRAP -Coordenação Tripartite da Política Nacional de Enfrentamento ao Tráfico de Pessoas e o Comitê Nacional de Enfrentamento ao Tráfico de Pessoas
CONCAR - Comissão Nacional de Cartografia
CONCEA - Conselho Nacional de Controle de Experimentação Animal
CONCEX - Comissão Executiva do Conselho Nacional do Comércio Exterior
CONCIDADES  - Conselho das Cidades
CONCLA - Comissão Nacional de Classificação
CONCRAB - Confederação Nacional de Cooperativas da Reforma Agrária
CONDEC - Conselho Nacional de Defesa Civil 
CONDECINE - Contribuição para o Desenvolvimento da Indústria Cinematográfica
CONDEL/FCO - Conselho Deliberativo do Fundo Constitucional de Financiamento do Centro-Oeste
CONDEPI - Conselho Nacional de Pós-Graduação em Direito
CONDRAF - Conselho Nacional de Desenvolvimento Rural Sustentável
CONFAEAB – CONFEDERAÇÃO DAS FED. DE ENGENHEIROS AGRÔNOMOS DO BRASIL
CONFAZ - Conselho Nacional de Política Fazendária
CONFEA - Conselho Federal de Engenharia, Arquitetura e Agronomia
CONIC - Conselho Nacional de Igrejas Cristãs 
CONIMA – Conselho Nacional das Instituições de Mediação e Arbitragem
CONIT - Conselho Nacional de Integração de Políticas de Transporte - DEC Nº 6.550/ 27.08.2008
CONMETRO - Conselho Nacional de Metrologia, Normalização e Qualidade Industrial
CONOTE - Programa Nacional da Racionalização do uso dos Derivados do Petróleo e do Gás Natural 
CONPET - Programa Nacional de Racionalização do Uso dos Derivados de Petróleo e do Gás Natural
CONSEA  - Conselho Nacional de Segurança Alimentar
CONSEGUE - Comissão Nacional de Prevenção da Violência e Segurança nos Espetáculos Esportivos
CONSED - Conselho Nacional dos Secretários do Estado de Educação
CONSEP – Conselho Estadual de Segurança Pública (Pará)
CONSIPAM - Conselho Deliberativo do Sistema de Proteção da Amazônia 
CONSU - Conselho Nacional de Saúde Suplementar 
CONTAE - CONSELHO NACIONAL DAS ASSOCIAÇÕES DE TÉCNICOS INDUSTRIAIS
CONTAG - Confederação Nacional dos Trabalhadores na Agricultura
CONTICOM - Confederação Nacio dos Trabalhadores da Indústria de Madeira e Construção
CONTRAN - Conselho Nacional de Trânsito 
CONTRANDIFE - Conselho de Trânsito do Distrito Federal
CONTREN  -  CONCESSIONÁRIA DE TRANSMISSÃO DE ENERGIA S/A
CONUT - Confederação Nac dos Usuários dos Transp Coletivo Rodov, Ferroviário, Hidroviário e Aeroviário
COOPERFORTE - Cooperativa de Economia e Crédito Mútuo dos Funcionários de Institutos Financeiros Públicos Federais
COOPEROSTRA - Cooperativa dos Produtores de Ostras de Cananéia - SP
COPAB - Confederação Brasileira de Aposentados e Pensionistas
COPEI - Coordenação Geral de Pesquisa de Investigação
COPEL - Companhia Paranaense de Eletricidade 
COPOM - Comitê de Política Monetária 
CORDE - Coordenadoria Nacional de Integração da Pessoa Portadora de Deficiência
COREMEC - Comitê de Regulação e Fiscalização dos Mercados Financeiro, de Capitais, de Seguros, de Previdência e Capitalização
CORPAM - Comissão Coordenadora Regional de Pesquisas na Amazônia 
COSIF  - Plano Contábil das Instituições do Sistema Financeiro Nacional - (BC)
COSIGUA - Companhia Siderúrgica de Guanabara
COSIPA - Companhia Siderúrgica Paulista 
COT - Comando de Operações Táticas (Polícia Federal) 
CPA - Comissão de Política Aduaneira 
CPA - Comissão Própria de Avaliação
CPB - Comitê Paraolímpico Brasileiro
CPC - Código de Processo Civil
CPC - Centro Popular de Cultura
CPDOC - Centro de Pesquisa e Documentação de História Contemporânea (FGV) 
C-PEM - Curso de Política e Estratégia Marítimas
CPF - Cadastro de Pessoas Físicas
CPFA  - Carreira de Perito Federal Agrário
CPFGCN - Comitê de Participação no Fundo de Garantia para a Construção Naval
CPFL - Companhia Paulista de Força e Luz 
CPGF - Cartão de Pagamento do Governo Federal
CPH - Companhia de Portos e Hidrovias - PA 
CPI - Comissão Parlamentar de Inquérito 
CPMF - Contribuição Provisória sobre a Movimentação Financeira
CPMI - Comissão Parlamentar Mista de Inquérito
CPOB - Comitê Paraolímpico Brasileiro
CPOR - Centro de Preparação de Oficias da Reserva (Exército)
CPR - Cédulas de Produto Rural 
CPRM - Companhia de Pesquisa de Recursos Minerais
CPST -  Contratos de Prestação de Serviços de Transmissão
CPST  - Carreira da Previdência, da Saúde e do Trabalho
CPT - Comissão Pastoral da Terra
CPT - Companhia Pontagrossense de Telecomunicações
CPTM – Cia Paulista de Trens Metropolitanos
CQR - Companhia Química do Recôncavo
CR - CARTA REGISTRADA SEM VALOR DECLARADO (Correios)
CRA - Certificado de Recebíveis do Agronegócio
CRA - Cota de Reserva Ambiental
CRAS - Conselhos Regionais de Assistentes Sociais
CRB - Conferência dos Religiosos do Brasil
CRBB  - Conselhos Regionais de Biologia e Biomedicina
CRDD - Conselhos Regionais dos Despachantes Documentalistas dos Estados e do Distrito Federal  
CREA - Conselho Regional de Engenharia e Arquiteturas  
CRECI - Conselho Regional de Corretores de Imóveis  
CRED - Conselhos Regionais de Economistas Domésticos
CRESS - Conselhos Regionais de Serviço Social 
CRF - Certificado de Regularidade do FGTS
CRF - Conselho Regional de Farmácia  
CRF - Conselho Regional de Fonoaudiologia 
CRLV - Certificado de Registro e Licenciamento Anual
CRM - Conselho Regional de Medicina  
CRMV - Conselhos Regionais de Medicina Veterinária 
CRPC - Câmara de Recursos da Previdência Complementar
CRPRP - Conselhos Regionais de Profissionais de Relações Públicas
CRPS - Conselho de Recursos da Previdência Social
CRSFN - Conselho de Recursos do Sistema Financeiro Nacional
CRTPS - Conselho de Recursos do Trabalho e da Previdência Social
CRUB - Conselho de Reitores das Universidades do Brasil
CRV  - Certificado de Registro de Veículos
CSA  - Carteira do Seguro-Desemprego e do Abono Salarial
CSLL - Contribuição Social sobre o Lucro Líquido
CSMA - Conselho Superior do Meio Ambiente
CSN - Companhia Siderúrgica Nacional  
CSN - Conselho de Segurança Nacional
CSPE (SP) - Comissão de Serviços Públicos de Energia do Estado de São Paulo
CSSA - Comissão Setorial de Convívio com o Semi-Árido e Inclusão Social no Nordeste e Norte do Estado de Minas Gerais
CSP - Conselho Superior de Polícia (RS)
CSPS - Conselho Superior da Previdência Social
CTB - Código de Trânsito Brasileiro CTBel - Companhia de Transporte de Belém 
CTC  - Certidão de Tempo de Contribuição
CTF - Comissão Federal do Comércio
CTFA - Comitê Técnico do Fundo Amazônia
CTNBio - Comissão Técnica Nacional de Biossegurança
CTP - Certificado de Transferência de Pássaro
CTPS - Carteira de Trabalho e Previdência Social
CTSE  - Curso de Treinamento para o Serviço no Exterior
CTU - Conselho de Terras da União
CTV - Confederação dos Trabalhadores da Venezuela
CTVF - Complemento Temporário Variável (BB)
CUT - Central Única dos Trabalhadores 
CV - Comanda Vermelho  
CVE - Centro de Vigilância Epidemiológica  
CVM - Comissão de Valores Mobiliários
CVRD - Companhia Vale do Rio Doce
CVRL – Comando Vermelho Rogério Lemgruber
CVS -Centro de Vigilância Sanitária
CZPE - Conselho Nacional das Zonas de Processamento de Exportação
DAC – Departamento de Aviação Civil
DACTA - Defesa Aérea e Controle de Tráfego Aéreo
DAE - Diretoria de Assistência ao Estudante
DAG  - Departamento de Administração Geral (Polícia Civil DF)
DAI - Declaração Anual de Isento
DAP -   Departamento de Administração Policial (RS)
DAR - Documento de Receita de Estados e/ou Municípios
DARF - Documento de Arrecadação de Receitas Federais
DAS - Direção e Assessoramento Superiores
DAT - Data de Afastamento do Trabalho (INSS)
DATAPREV - Empresa de Tecnologia e Informações da Previdência Social 
DATASUS - Departamento de Informática do Sistema Único de Saúde
DAU - Dívida Ativa da União
DAVES - Departamento de Apoio ao Vestibular (UFPa)
DCEs - Diretórios Centrais dos Estudantes
DECA - Departamento Estadual para Criança e Adolescente (RS)
DECOIE - Divisão de Repressão ao Crime Organizado e Inquéritos Especiais
DEC - Duração Equivalente de Interrupção (enérgia elétrica)
DECRIF - Delegacia de Crimes Funcionais
DEES - Departamento de Educação Especial
DEIC - Departamento de Combate ao Crime Organizado
DEIC - Departamento Estadual de Investigações Criminais (RS)
DEIC - Departamento Estadual de Investigações Criminais
DEMA - Delegacia Especializada em Meio Ambiente
DENARC - Departamento de Investigações sobre Narcóticos
DENARC - Departamento Estadual de Investigações do Narcotráfico (RS)
DENASUS - Departamento Nacional de Auditoria do Sistema Único de Saúde
DENATRAN - Departamento Nacional de Trânsito
DER - Data da Entrada do Requerimento (INSS)
DEST- Departamento de Coordenação e Controle das Empresas Estatais 
DETEL - Departamento Estadual de Telecomunicações (RS)
DETRAN - Departamento de Trânsito
DFI - Danos Físicos ao Imóvel
DGPL -  Delegacia Geral de Portos e Litoral
DI - Divisão de Infantaria
DI - Declaração de Importação
DIAC - Documento de Informação e Atualização Cadastral do ITR
DIC - Duração de Interrupção Individual (enérgia elétrica)
DIEESE - Departamento Intersindical de Estatísticas e Estudos Sócio-Econômicos
DII - Data de Início de Incapacidade (INSS)
DIMOB - Declaração de Informações sobre Atividades Imobiliárias ( RF)
DINP - Departamento Estadual de Informática Policial (RS)
DIOE - Divisão de Investigações de Operações Especiais
DIP - Data do Início do Pagamento (INSS)
DIPJ - Declaração de Informações Econômico-fiscais da Pessoa Jurídica
DIVICOM - Divisão de Comunicação (Polícia Civil DF)
DMF. (CNJ) - Departamento de Monitoramento e Fiscalização do Sistema Carcerário e do Sistema de Execução de Medidas Socioeducativas
DMIC - Duração Máxima de Interrupção Contínua (enérgia elétrica)
DNAEE - Departamento Nacional de Águas e Energia Elétrica
DNC - Departamento Nacional de Combustíveis
DNEF - Departamento Nacional de Estradas de Ferro 
DNER - Departamento Nacional de Estradas de Rodagem (aual DNIT)
DNIT - Departamento Nacional de Infra-Estrutura de Transporte (ex-DNER)
DNOCS - Departamento Nacional de Obras Contra as Secas 
DNOS - Departamento Nacional de Obras e Saneamento 
DNPM -  Departamento Nacional de Produção Mineral
DNPS - Departamento Nacional de Previdência Social
DNRC - Departamento Nacional do Regitro do Comércio
DNV - Declaração de Nascido Vivo 
DOF - Documento de Origem Florestal (antigo ATPF)
DOI - Destacamento de Operações Internas
DOPS - Delegacia de Ordem Política e Social
DORT  - Distúrbios Osteomusculares Relacionados ao Trabalho
DORT - Doença Ocupacional por Repetição do Trabalho
DPC - Diretoria de Portos e Costas do Comando da Marinha
DPDE – Departamento de Proteção e Defesa Econômica (Ministério da Justiça)
DPG - Departamento de Provisão Geral
DPG - Data do Pagamento  (INSS)
DPI - Departamento de Polícia do Interior (RS)
DPM - Departamento de Polícia Metropolitana (RS)
DPRF - Departamento de Polícia Rodoviária Federal
DPTRAN -  Departamento Estadual de Polícia  Judiciária de Trânsito (RS)
DRCI - Departamento de Recuperação de Ativos e Cooperação Jurídica Internacional
Dpvat - Seguro de Danos Pessoais Causados por Veículos Automotores Terrestres
DRCO - Divisão de Repressão ao Crime Organizado
DRD - Data de Regularização da Documentação ( INSS)
DRE - Delegacia de Repressão a Entorpecentes (Polícia Federal)
DRT - Delegacia Regional do Trabalho
DRU - Desvinculação das Receitas da União
DST - Doenças Sexualmente Transmissíveis  
DTC - Divisão de Terras e Colonização
EAF - Escola Agrotécnica Federal
EAOT - Estágio de Adaptação de Oficiais Temporários (Aeronáutica)
EBC - Empresa Brasil de Comunicação
EBSERH - Empresa Brasileira de Serviços Hospitalares S.A.
EBTU - Empresa Brasileira de Transportes Urbanos
ECA - Estatuto da Criança e Adolescente
ECAD -  Escritório Central de Arrecadação e Distribuição de Direitos Autorais
ECT - Empresa Brasileira de Correio e Telégrafos
EDUCAR - Fundação Nacional para Educação de Jovens e Adultos
EDUCAFRO - Movimento Educação e Cidadania de Afrodescendente e Carentes
EE - EMS - EXPRESS MAIL SERVICE (Correios)
EFPC - Entidade Fechada de Previdência Complementar
EFPP - Entidades fechadas de previdência privada
EIRELI - Empresa individual de responsabilidade limitada
ELETROBRÁS - Centrais Elétricas do Brasil S.A
ELETRONORTE - Centrais Elétricas do NorteELETRONUCLEAR - Eletrobrás Termonuclear S/A
EMBRAER - Empresa Brasileira de Aeronáutica S.A.
EMBRAFILME - Empresa Brasileira de Filmes S.A.
EMBRAPA - Empresa Brasileira de Pesquisa Agropecuária
EMBRATEL - Empresa Brasileira de Telecomunicações
EMBRATER - Empresa Brasileira de Assistência Técnica e Extensão Rural
EMBRATUR - Empresa Brasileira de Turismo  (antigo)
EMBRATUR - Instituto Brasileiro de Turismo (atual)
EME - Estado-Maior do Exército
EMFA  - Estado-Maior das Forças Armadas
EMGEA - Empresa Gestora de Ativos
EMGEPRON - Empresa Gerencial de Projetos Navais 
EMP - Evolução Média de Preços 
EN - ENCOMENDA NORMAL NACIONAL (Correios)
ENADE - Exame Nacional de Desempenho dos Estudantes
ENAP -  Escola Nacional de Administração Pública
ENCLA - Estratégia Nacional de Cambate à Lavagem de Dinheiro
ENEF - Estratégia Nacional de Educação Financeira
ENEM - Exame Nacional de Ensino Médio
ENERSUL - Empresa de Energia Elétrica de Mato Grosso do Sul 
ENFAM  - Escola Nacional de Formação e Aperfeiçoamento de Magistrados
ENM - Escola Nacional da Magistratura
EPE - Empresa de Pesquisa Energética
EPIA  - Estudo Prévio de Impacto Ambiental
ER - REGISTRADO (Correios)
ERB - Estação Rádio Base
ES - SEDEX COM VALOR DECLARADO (Correios)
ESAO - Escola de Aperfeiçoamento de Oficiais
ESCELSA - Espírito Santo Centrais Elétricas S.A.
ESCEME  - Escola de Comando e Estado-Maior do Exército
ESM - Escola Superior de Magistratura
ESMAL - Escola Superior da Magistratura do Estdo de Alagoas
ESNI - Escola Nacional de Informações
ESPIN - Emergência em Saúde Pública de Importância Nacional
ETAPA - Escola Técnica Estadual do Pará
ETC - Empresa de Transporte Rodoviário de Cargas 
ETF - Escola Técnica Federal
EVN – Expectativa de Vida ao Nascer
EZLN – Exército Zapatista de Libertação Nacional (México)
FA - Fundo Aeroviário
FAB - Força Aérea Brasileira
FÁCIL - Centrais de Atendimento Empresarial
FAD - Fundo de Amortização da Dívida Pública Mobiliária Federal
FADPMF -  Fundo de Amortização da Dívida Pública Mobiliária Federal
FAEMI - FEDERAÇÃO DAS ASSOCIAÇÕES DE ENGENHEIROS DE MINAS DO BRASIL
FAEP-BR - FEDERAÇÃO DAS ASSOC. DOS ENGENHEIROS. DE PESCA DO BRASIL
FAEPA - Faculdade de Estudos Avançados do Pará
FAFEID - Faculdades Federais Integradas de Diamantina
FAL - Fuzil Automático Leve
FAM - Fundo de Apoio à Moradia
FAO – Organização das Nações Unidas para a Alimentação e Agricultura
FAP - Fator Acidentário de Prevenção
FAPESP - Fundação de Amparo à Pesquisa do Estado de São Paulo
FAPI - Fundo de Aposentadoria Programável Individual
FAR - Fundo de Arrendamento Residencial
FARC - Forças Armadas Revolucionárias da Colômbia
FAS - Fundo de Apoio ao Desenvolvimento Social
FAT - Fundo de Amparo ao Trabalhador
FBAPEF - Federação Brasileira das Associações dos Profissionais de Educação Física
FBB - Fundação Banco do Brasil 
FBES - Fórum Brasileiro de Economia Solidária
FBG – Federação Brasileira de Gastroenterologia
FBI - Federal Bureau of Investigation (EUA)
FBN - Fundação Biblioteca Nacional
FBOMS - Fórum Brasileiro de ONGs e Movimentos Sociais para o Meio Ambiente e o Desenvolvimento
FCAP - Faculdade de Ciências Agrárias do Pará
FCDA - Federação Cearense de Desportos Aquáticos
FCB - Fundação do Cinema Brasileiro
FCBC - Funções Comissionadas do Banco Central
FCDF - Fundo Constitucional do Distrito Federal 
FCO - Fundos Constitucionais de Financiamento do  Centro-Oeste
FCP - Fundação Cultural Palmares 
FCPS - Fundo Comum da Previdência Social
FCRB - Fundação Casa de Rui Barbosa FCT - Funções Comissionadas Técnicas
FCVS - Fundo de Compensação de Variação Salariais 
FDA - Fundo de Desenvolvimento da Amazônia
FDCO - Fundo de Desenvolvimento do Centro-Oeste
FDD - Fundo de Defesa de Direitos Difusos  (Ministério da Justiça)
FDG - Fundação de Desenvolvimento Gerencial
FDNE - Fundo de Desenvolvimento do Nordeste
FDS - Fundo de Desenvolvimento Social 
FE - ENCOMENDA FNDE (Correios)
FEAPA - Federação de Estudos Avançados do Pará
FEA-USP - Faculdade de Economia da Universidade de São Paulo
FEB - Força Expedicionária Brasileira
FEBEM - Fundação Estadual do Bem-Estar Social do Menor
FEBRABAN - Federação Brasileira das Associações de Bancos
FEBRAE - FEDERAÇÃO BRASILEIRA DE ASSOCIAÇÕES DE ENGENHEIROS
FEBRAGEO - FEDERAÇÃO BRASILEIRA DE GEÓLOGOS
FEC - Frequência Equivalente de Interrupção (enérgia elétrica)
FECOB - Federação das Cooperativas de Consumo dos Funcionários do Banco do Brasil
FEDOCEF - Fundo Especial de Desenvolvimento das Operações das Caixas Econômicas Federais
FEFAM - Fundo Especial de Financiamento da Assistência Médica
FEMI - Fundo Especial de Manutenção e Investimentos
FENADEPOL - Federação Nacional dos Delegados de Polícia Federal
FENAJ - Federação Nacional dos Jornalistas
FENAPEF - Federação Nacional dos Policiais Federais
FENAPRF - Federação Nacional dos Policiais Rodoviários Federais
FENASEG - Federação Nacional das Empresas de Seguros Privados e de Capitalização
FENATA - FEDERAÇÃO NACIONAL DOS TÉCNICOS AGRÍCOLAS
FENAVIST - Federação Nacional das Empresas de Segurança e Transportes de Valor
FENEA - FEDERAÇÃO NACIONAL DOS ENGENHEIROS AGRIMENSORES
FENTEC - FEDERAÇÃO NACIONAL DOS TÉCNICOS INDUSTRIAIS
FERROESTE - Estrada de Ferro Paraná Oeste S.A.
FERRONORTE S.A. - Ferrovias Norte Brasil
FESA/fcvs - Fundo de Equalização de Sinistralidade da Apólice de Seguro Habitacional - 
FESPIM - Fundo Especial de Serviços Públicos e Investimentos Municipais
FESR - Fundo de Estabilidade do Seguro Rural
FF - Registrado Detran (Correios)
FFFCMPA - Fundação Faculdade Federal de Ciências Médicas de Porto Alegre 
FG - Função Gratificada 
FGC - Fundo Garantidor de Crédito
FGCN - Fundo de Garantia para a Construção Naval
FGE - Fundo de Garantia à Exportação
FGEDUC - Fundo de Garantia de Operações de Crédito Educativo
FGEE - Fundo de Garantia a Empreendimentos de Energia Elétrica
FGHab - Fundo Garantidor da Habitação Popular
FGPC - Fundo de Garantia para a Promoção da Competitividade
FGTS - Fundo de Garantia por Tempo de Serviço
FGV - Fundação Getúlio Vargas
FHC - Fernando Henrique Cardoso
FHE - Fundação Habitacional do Exército
FIA - Federação Internacional de Automobilismo
FIA - Fundação para a Infância e Adolescência (RJ)
FIBRA - Faculdade Integrada Brasil Amazônia
FIC - Frequência de Interrupção Individual (enérgia elétrica)
FIDA - Fundo Internacional de Desenvolvimento da Agricultura
FIDC - Fundos de Investimento em Direitos Creditórios
FIDES  - Fundação Instituto de Desenvolvimento Empresarial e Social
FIEMG – Federação das Indústrias de Minas Gerais
FIEPA - Federação da Industrias do Estado do Pará
FIERGS - Federação das Indústrias do Rio Grande do Sul
FIES - Fundo de Financiamento ao Estudante do Ensino Superior  alterado para FIES - Fundo de Financiamento Estudantil
FIESP - Federação das Indústrias do Estado de  São Paulo
FI-FGTS - Fundo de Investimento do Fundo de Garantia do Tempo de Serviço
FII - Fundos de Investimento Imobiliário
FINEP - Financiadora de Estudos e Projetos
FINSOCIAL - Fundo de Investimento Social
FINEP - Financiadora de Estudos e Projetos
FINOR - Fundo de Investimentos do Nordeste
FIOCRUZ - Fundação Oswaldo Cruz 
FIPE - Fundação Instituto de Pesquisas Econômicas
FIP-IE - Fundo de Investimento em Participações em Infra-Estrutura
FIRTOP - Fundação Interestadual para o Desenvolvimento dos Vales do Tocantins-Araguaia e Paraguai-Cuiabá
FISENGE - FEDERAÇÃO INTERESTADUAL DE SIND. DE ENGENHEIROS
FLACSO - Faculdade Latino-Americana de Ciências Sociais
FLAM - Federação Latino-Americana de Magistrados
FLUMITRENS - Companhia Fluminense de Trens Urbanos
FMI - Fundo Monetário Internacional
FMM - Fundo da Marinha Mercante
FNA - FEDERAÇÃO NACIONAL DOS ARQUITETOS E URBANISTAS
FNABF - Fórum Nacional das Atividades de Base Florestal
FNCA - Fundo Nacional da Criança e do Adolescente
FND - Fundo Nacional de Desestatização
FND - Fundo Nacional de Desenvolvimento
FNDC - Fundo Nacional de Democratização da Comunicação
FNDCT  - Fundo Nacional de Desenvolvimento Científico e Tecnológico 
FNDE - Fundo Nacional de Desenvolvimento da Educação
FNDF - Fundo Nacional de Desenvolvimento Florestal
FNE - Fundos Constitucionais de Financiamento do Nordeste
FNE - FEDERAÇÃO NACIONAL DOS ENGENHEIROS 
FNFi - Faculdade Nacional de Filosofia
FNHIS - Fundo Nacional de Habitação de Interesse Social
FNIT - Fundo Nacional de Infra-Estrutura de Transportes
FNMA - Fundo Nacional do Meio Ambiente
FNMC - Fundo Nacional sobre Mudança do Clima
FNO - Fundo Constitucional de Financiamento do Norte
FNS  - Fundação Nacional de Saúde
FNSA - Fórum Nacional dos Secretários de Agricultura
FN-SUS - Força Nacional do Sistema Único de Saúde
FPC - Federação Paraense de Capoeira
FPD - Federação Paraense de Futebol
FPE - Fundo de Participação dos Estados
FPM - Fundo de Participação dos Municípios
FPR  - Fórmula Paramétrica de Reajuste de Preços de Medicamentos
FRANAVE - Companhia de Navegação do São Francisco
FRESP - Federação das Empresas de Transporte de Passageiros por Fretamento do Estado de São Paulo
FQM - Fundo de Quitação por Morte
FSESP - Fundação Serviços de Saúde
FUCAPI - Fundação Centro de Análise, Pesquisa e Inovação Tecnológica
FUMEC - Fundação Mineira de Educação e Cultura
FUMET - Fundo de Metrologia
FUNABEM - Fundação Nacional do Bem-Estar do Menor 
FUNAD  - Fundo Nacional Antidrogas
FUNAI - Fundação Nacional do Índio
FUNAPOL - Fundo para Aparelhamento e Operacionalização das Atividades-fim da Polícia Federal
FUNARTE - Fundação Nacional de Artes
FUNASA  - Fundação Nacional de Saúde
FUNCAB  - Fundo de Prevenção, Recuperação e de Combate ao Abuso de Drogas  
FUNCAFÉ  - Fundo de Defesa da Economia Cafeeira
Funcap  - Fundo Nacional para Calamidades Públicas, Proteção e Defesa Civil
FUNCAP - Fundo Especial para Calamidades Públicas 
FUNCAP – Fundação da Criança e do Adolescente (Pará) 
FUNCEF - Fundação dos Economiários Federais
FUNCEP - Fundação Centro de Formação do Servidor Público
FUNCINES - Fundos de Financiamento da Indústria Cinematográfica Nacional 
FUNDACEN - Fundação Nacional de Artes Cênicas 
FUNDACENTRO - Fundação Jorge Duprat Figueiredo de Segurança e Medicina do Trabalho
FUNDAF - Fundo Especial de Desenvolvimento e Aperfeiçoamento das Atividades de Fiscalização
FUNDAJ - Fundação Joaquim Nabuco
FUNDEB - Fundo de Manutenção e Desenvolvimento da Educação Básica  e Valorização dos Profissionais de Educação 
FUNDEF - Fundo de Manutenção e  Desenvolvimento do Ensino Fundamental e  de Valorização do Magistério
FUNDHAB - Fundo de Assistência Habitacional 
FUNGETUR - Fundo Geral de Turismo
FUNIN - Fundo de Imprensa Nacional 
FUNPAPA - Fundação João XXIII (Pa)
FUNPEN - Fundo Penitenciário Nacional
FUNPRESP-Exe - Fundação de Previdência Complementar do Servidor Público Federal do Poder Executivo
FUNPRESP-Jud - Fundação de Previdência Complementar do Servidor Público Federal do Poder Judiciário
FUNPRESP-Leg - Fundação de Previdência Complementar do Servidor Público Federal do Poder Legislativo 
FUNPROGER - Fundo de Aval para a Geração de Emprego e Renda
FUNRES - Fundo de Recuperação Econômica do Estado do Espírito Santo
FUNSET - Fundo Nacional de Segurança e Educação de Trânsito
FUNTEC - Fundo de Tecnologia do Estado - (Pará)
FUNTEVÊ - Fundação Brasileira Centro de TV Educativa
FUNTTEL - Fundo para o Desenvolvimento Tecnológico das Telecomunicações
FUP - Fundação Única dos Petroleiros
FURB - Fundação Universidade Regional de Blumenau
FURNAS - Centrais Elétricas S.A
FUST - Fundo de Universalização dos Serviços de Telecomunicações 
GAE - Gratificação de Atividade
GAFI/FATF - Grupo de Ação Financeira contra a Lavagem de Dinheiro e o Financiamento do Terrorismo
GASBOL  - Gasoduto Bolívia-Brasil
GASCAV - Gasoduto Cabiúnas-Vitória
GASFOR II - Gasoduto Serra do Mel - Pecém
GATT - Acordo Geral sobre Tarifas Aduaneiras e Comércio
GBENIN - Gerenciamento de Benefícios por Incapacidade e Reabilitação Profissional (INSS)
GC – Gerador de Caracteres (Televisão)
GCB - Gerenciador do Correspondente Bancário
GCEF - Gratificação de Condição Especial de Função Militar
GCG - Gratificação de Desempenho de Atividade do Ciclo de Gestão
GDACABIN - Gratificação de Desempenho de Atividades Complementares na ABIN
GDACVM - Gratificação de Desempenho da Atividade de Apoio Técnico-Administrativo da Comissão de Valores Mobiliários
GDADNIT - Gratificação de Desempenho de Atividades Administrativas do DNIT
GDADNPM - Gratificação de Desempenho de Atividades Administrativas do DNPM
GDAHFA - Gratificação de Ratificação de Desempenho de Atividades Hospitalares do Hospital das Forças Armadas 
GDAI - Gratificação de Desempenho de Atividades de Informação
GDAIT - Gratificação de Desempenho de Atividade de Infraestrutura de Transportes
GDAIN - Gratificação de Desempenho de Atividades de Informações e Inteligência
GDAIN - Gratificação de Desempenho de Atividade Indigenista 
GDAJ - Gratificação de Desempenho de Atividade Jurídica
GDAMP - Gratificação de Desempenho de Atividade Médico-Pericial
GDAPA  - Gratificação de Desempenho de Atividade Previdenciária
GDAPA - Gratificação de Desempenho de Atividade de Perito Federal Agrário
GDAPDNPM - Gratificação de Ratificação de Desempenho de Atividades Administrativas do Plano Especial de Cargos do DNPM
GDAPM - Gratificação de Desempenho de Atividades de Produção Mineral
GDAPREVIC - Gratificação de Desempenho de Atividade na Superintendência de Previdência Complementar
GDAR - Gratificação de Desempenho de Atividade de Regulação
GDARA - Gratificação de Desempenho de Atividade de Reforma Agrária
GDARM - Gratificação de Desempenho de Atividade de Recursos Minerais
GDASA  - Gratificação de Desempenho de Atividade de Controle e Segurança de Tráfego Aéreo
GDASS - Gratificação de Desempenho de Atividade do Seguro Social
GDASUS - Gratificação de Desempenho de Atividade de Execução e Apoio Técnico à Auditoria
GDASUS - Gratificação de Desempenho de Atividade de Execução e Apoio Técnico à Auditoria no Departamento Nacional de Auditoria do Sistema Único de Saúde
GDAT - Gratificação de Desempenho de Atividade Tributária
GDATA - Gratificação de Desempenho de Atividade Técnico-Administrativa
GDATFA - Gratificação de Desempenho de Atividade Técnica de Fiscalização Agropecuária
GDATR - Gratificação de Desempenho de Atividade Técnico-Administrativa em Regulação
GDCT - Gratificação de Desempenho de Atividade de Ciência e Tecnologia
GDCVM - Gratificação de Desempenho de Atividade de Auditoria de Valores Mobiliários
GDE - Gratificação de Desempenho e Eficiência
GDI - Gratificação de Desempenho de Atividade de Informações Estratégicas
GDIBGE - Gratificação de Desempenho em Atividade de Pesquisa, Produção e Análise, Gestão e Infra-Estrutura de Informações Geográficas e Estatísticas
GDRH - Gratificação de Desempenho de Atividade de Recursos Hídricos 
GDSUSEP - Gratificação de Desempenho de Atividade de Auditoria de Seguros Privados
GEAC - Gratificação Específica de Atividade Cultural
GEAPF  - Gratificação Específica de Apoio Técnico-Administrativo à Atividade Policial Federal
GEAPRF  - Plano Especial de Cargos do Departamento de Polícia Rodoviária Federal
GEASEB - Gratificação Específica de Apoio Técnico e Administrativo ao Serviço Exterior Brasileiro
GECTA - Gratificação Especial de Controle do Tráfego Aéreo
GEDET - Gratificação Específica de Docência dos servidores dos extintos Territórios Federais do Acre, Amapá, Rondônia e Roraima
GEDR - Gratificação de Efetivo Desempenho em Regulação
GEFA - Gratificação de Estímulo à Fiscalização e Arrecadação
GEFM - Gratificação Especial de Função Militar
GEIPOT - Grupo Executivo de Integração da Política de Transportes
GEPDIN - Gratificação Específica de Publicação e Divulgação da Imprensa Nacional
GEPRA - Gratificação Especial de Perito Federal Agrário
GERASUL - Centrais Geradoras do Sul do Brasil S.A. - 
GERES - Grupo Executivo para Recuperação Econômica do Estado do Espírito Santo
GESEC - Grupo-Executivo para Coordenação e Acompanhamento do Programa Emergencial de Combate aos Efeitos da Seca
GESPÚBLICA - Programa Nacional de Gestão Pública e Desburocratização 
GESS - Gratificação Específica do Seguro Social
GFIP - Guia de Recolhimento do Fundo de Garantia do Tempo de Serviço e de Informações à Previdência  Social
GGA - Grupo Gay de Alagoas
GGB - Grupo Gay da Bahia
GGI - Gabinete de Gestão Integrada
GHQ - Gratificação de Habilitação e Qualificação
GHS - Sistema Globalmente Harmonizado de Classificação e Rotulagem de Produtos Químicos
GIAAS - Gratificação de Incentivo à Atividade Intensiva de Assistência à Saúde
GIAPU - Gratificação de Incremento à Atividade de Administração do Patrimônio da União
GIEN - Grupo Internacional de Estudos sobre o Níquel
GIFA - Gratificação de Incremento da Fiscalização e da Arrecadação
GIPAS - Gratificação de Incentivo à Prestação de Assistência Integral à Saúde
GLBTT - Gays, Lésbicas, Bissexuais, Travestis e Transexuais
GLOBOPAR - Globo Comunicações e Participações S.A.
GLP - Gás Liquefeito de Petróleo
GM - General Motors
GMC - Grupo Mercado Comum
GNCOPP - Grupo Nacional de Combate à Corrupção e Defesa do Patrimônio Público
GNV - Gás Natural Veicular
GPS - Guia de Recolhimento da Previdência Social
GRADI - Grupo de Repressão e Análise dos Delitos de Intolerância
GRU - Guia de Recolhimento da União
GS - Gratificação Semestral (BB)
GSE - Guia do Salário-Educação
GSI - Gabinete de Segurança Institucional
GSISTE - Gratificação Temporária das Unidades dos Sistemas Estruturadores da Administração Pública Federal
GTA – Grupo de Trabalho Amazônico
GTA - Grupo Tático Armado
GTAG - Grupo de Trabalho Interministerial de Acompanhamento de Gastos Públicos do Governo Federal
GTEMA - Gratificação de Desempenho de Atividade Técnico-Executiva e de Suporte  do Meio Ambiente
GTI - Grupo de Trabalho Interministerial
GTI-PNSB - Grupo de Trabalho Interinstitucional de Acompanhamento da Implementação do Plano Nacional de Saneamento Básico
GTI-PLANSAB - Grupo de Trabalho Interinstitucional do Plano Nacional de Saneamento Básico
GTMS - Gratificação Temporária para o Magistério Superior
GTS - Gratificações Temporárias Sipam
GU - Grau de Utilização
HABITAT - Centro das Nações Unidas para Assentamentos Humanos
HBO – Home Box Office (Tv por assinatura)
HBV - Horário Brasileiro de Verão
HCE - Hospital Central do Exército
HDL - High density lipoprotein - liproprotínas de alta densidade (colesterol alto)
HFA - Hospital das Forças Armadas
HEMOBRÁS -  Empresa Brasileira de Hemoderivados e Biotecnologia
HIV - Vírus da Imunodeficiência Humana 
HOL - Hospital Ofir Loyola- - Belém - Pa
HPM - hospital da Polícia Militar
HPV – Papiloma Vírus Humano
IAA - Instituto do Açúcar e do Álcool
IAB - INSTITUTO DE ARQUITETOS DO BRASIL
IAPAS  - Instituto de Administração Financeiro da Previdência e Assistência Social
IAPFESP - Instituto de Aposentadoria e Pensões dos Ferroviários e Empregados em Serviços PúblicosIAPM - Instituto Arquidiocesano de Promoção do Menor 
IBAC - Instituto Brasileiro da Arte e Cultura
IBAP - Instituto Brasileiro dos Advogados Públicos
IBAMA  - Instituto Brasileiro do Meio Ambiente e dos Recursos Naturais Renováveis 
IBAP  - Instituto Brasileiro de Advocacia Pública
IBAPE - INSTITUTO BRAS. DE AVALIAÇÕES E PERÍCIAS DE ENGENHARIA
IBASE - Instituto Brasileiro de Análises Sociais e Econômicas
IBC - Instituto Brasileiro do Café
IBCCRim - Instituto Brasileiro de Ciências Criminais 
IBCPF - Instituto Brasileiro de Certificação de Profissionais Financeiros
IBDE - Instituto Brasileiro de Direito Eletrônico
IBDF  - Instituto Brasileiro de Desenvolvimento Florestal
IBDF  - Instituto Brasiliense de Direito Público
IBDFAM - Instituto Brasileiro de Direito de Família
IBDS - Instituto de Direito do Seguro
IBGE - Instituto Brasileiro de Geografia e Estatística
IBGM - Instituto Brasileiro de Gemas e Metais Preciosos
IBICT  - Instituto Brasileiro de Informação em Ciência e Tecnologia
IBOVESPA - Índice BOVESPA
IBPC - Instituto Brasileiro do Patrimônio Cultural
IBPT - Instituto Brasileiro de Planejamento Tributário
IBRACON - Instituto dos Auditores Independentes do Brasil
IBRADES - Instituto Brasileiro de Desenvolvimento
IBRE - Instituto Brasileiro de Economia
IBRI - Instituto Brasileiro de Relações com Investidores
IBV - Índice da Bolsa de Valores (RJ)
IC - Inteligência Competitiva
ICCE - Instituto de Criminalística Carlos Éboli
ICEAAL - Institut de Cooperation Europe Asie Amerique Latine
ICMS - Imposto sobre Circulação de Mercadorias e Serviços
ICOM - Conselho Internacional de Museus -UNESCO
ICP-Brasil - Infra-Estrutura de Chaves Públicas Brasileira
ICSS - Instituto Cultural de Seguridade Social
ICT - Instituição Científica e Tecnológica
IDEC - Instituto Brasileiro de Defesa do Consumidor
IDH - Índice de Desenvolvimento Humano
IDSM - Instituto de Desenvolvimento Sustentável Mamirauá
IE - Imposto sobre Exportação, para o Exterior, de Produtos Nacionais ou Nacionalizados
IEAB - Igreja Episcopal Anglicana do Brasil
IECA - Instituto  de Educação e Cultura da Amazônia
IEDI - Instituto de Estudos para o Desenvolvimento Industrial
IEF - Indicado de Eqüidade Fiscal
IESAM - Instituto de Educação Superior da Amazônia - Pará
IFET - Instituições Federais de Educação Tecnológica
IFF - Institute of International Finance
IFFHS - Federação Internacional de História e Estatística do Futebol (Sigla alemã)
IGP-DI - Índice Geral de Preços - Disponibilidade Interna
IGP-M - Índice Geral de Preços do Mercado
II - Imposto sobre Importação de Produtos Estrangeiros
IICA - Instituto Interamericano de Cooperação para a Agricultura 
ILANUD - Instituto Americano das Nações Unidas para a Prevenção do Deltio e Tratamento do Delinquente
ILPF - Integração Lavoura-Pecuária-Floresta
IMBEL - Indústria de Material Bélico do Brasil
IMEP - Instituto de Metrologia do Pará
IML - Instituo Médico Legal
IN - OBJETOS RECEBIDOS DO EXTERIOR COM OUTRA NUMERAÇÃO (Correios)
INAN - Instituto Nacional de Alimentação e Nutrição
INB - Indústrias Nucleares Brasileiras
INC - Assembléia de Igrejas Cristãs
INC - Computer Sales International
INCA - Instituto Nacional do Câncer
INCC  - Índice Nacional de Custo da Construção
INCRA - Instituto Nacional de Colonização e Reforma Agrária
INDEP -  Instituto Nacional de Desenvolvimento da Educação e Pesquisa
INDESP - Instituto Nacional de Desenvolvimento do Desporto
INEP - Instituto Nacional de Estudos e Pesquisas Educacionais Anísio Teixeira
INEP - Instituto Nacional de Pesquisas Educacionais
INFAZ - Companhia Brasileira de Infra-Estrutura Fazendária
INFORMAR - Sistema de Informações Gerenciais de Arrecadação
INFOSEG - Sistema Nacional de Integração de Informações em Justiça e Segurança Pública (MJ)
INFRAERO  - Empresa Brasileira de Infra-Estrutura Aeroportuária  
INI - Instituto Nacional de Identificação (Polícia Federal)
INPS - Instituto Nacional de Previdência Social
IMARSAT  - Organização Internacional de Telecomunicações Marítimas por Satélite
INMET - Instituto Nacional de Meteorologia
INMETRO - Instituto Nacional de Metrologia, Normalização e Qualidade Industrial
INOVAR-AUTO - Programa de Incentivo à Inovação Tecnológica e Adensamento da Cadeia Produtiva de Veículos Automotores
INSA - Instituto Nacional do Semi-Árido
INSS - Instituto Nacional de Seguridade Social
INP - Instituto Nacional do Pinho
INPC - Índice Nacional de Preços ao Consumidor
INPE - Instituto de Pesquisas Espaciais
INPI - Instituto Nacional de Propriedade Industrial
INPM - Instituto Nacional de Pesos e Medidas
INPS - Instituto Nacional de Previdência Social
INSA - Instituto Nacional do Semi-Árido
INSS - Instituto Nacional do Seguro Social
INT - Instituto Nacional de Tecnologia
INTELSAT - Organização Internacional de Telecomunicações por Satélite
INTERBRÁS - Petrobrás Comércio Internacional S.A.
IOF - Imposto sobre Operações de Crédito, Câmbio e Seguro, ou relativas a Títulos e Valores Mobiliários
IPALEP - Instituto de Previdência da Assembléia Legislativa do Pará
IPAMB – Instituto de Previdência e Assistência do Município de Belém
IPASE - Instituto de Previdência e Assistência dos Servidores do Estado 
IPC - Índice de Preços ao Consumidor
IPCA - Índice de Preços ao Consumidor Amplo
IPEA - Instituto de Pesquisa Econômica Aplicada
IPEA - Instituto de Pesquisa Econômica Aplicada
IPEC - Programa Internacional para a Erradicação do Trabalho Infantil
IPES - Instituto de Pesquisa e Estudos Sociais
IPHAN - Instituto do Patrimônio Histórico e Artístico Nacional
IPI - Imposto sobre Produtos Industrializados
IPM - Índice Paramétrico de Medicamentos
IPM - Inquérito Policial-Militar
IPTU - Imposto Predial e Territorial Urbano
IPVA - Imposto sobre a Propriedade de Veículos Automotores
IQA – Instituto de Qualidade Automotiva
IQC - Índice de Qualidade da Carteira
IR - Imposto de Renda
IR - IMPRESSO REGISTRADO (Correios)
IRB - Instituto de Resseguros do Brasil
IRCAMP -Instituto de Reabilitação de Campinas
IRPF - Imposto de Renda Pessoa Física
IRPJ - Imposto de Renda das Pessoas Jurídicas
ISA - Instituto Socioambiental
ISN -  Índice de Salários Nominais Médios
ISO - International Organization for Standardisation 
IST - Índice de Serviços de Telecomunicações 
ITCP's - Incubadoras Tecnológicas de Cooperativas Populares
ITA – Instituto Tecnológico da Aeronáutica
ITE - Indicador de Tributação Efetiva
ITI - Instituto Nacional de Tecnologia da Informação
ITR - Imposto Territorial Rural
IVA - Imposto do Valor Agregado
IVC - Instituto Verificador de Circulação (Jornal)
JARI - Juntas Administrativas de Recursos de Infrações
JB - Jornal do Brasil
JEC - Juventude Estudantil Católica
JUC - Juventude Universitária Católica
LALUR - Livro de Apuração do Lucro Real 
LBA - Fundação Legião Brasileira de Assistência 
LBC - Letras do Banco Central
LBV - Legião da Boa Vontade
LCA - Letra de Crédito do Agronegócio 
LCI - Letra de Crédito Imobiliário
LCP - Lei de Contravenções Penais
LDB - Lei de Diretrizes e Bases da Educação Nacional
LDL - Low density lipoprotein - liproprotínas de baixa densidade (colesterol baixo)
LDO - Lei de Diretrizes Orcamentárias
LEC - Liga Eleitoral Católica
LEP - Lei de Execuções Penais
LER - Lesão por Esforço Repetitivo
LFT - Letras Financeiras do Tesouro
LFTMS - Letra Financeira do Tesouro Municipal (SP)
LIBRAS - Língua Brasileira de Sinais
LLOYDBRÁS - Companhia de Navegação Lloyd Brasileiro
LOA - Lei Orçamentária Anual
LOAS - Lei Orgânica da Assistência Social 
LOMB - Lei Orgânica do Município de Belém
LRF - Lei de Responsabilidade Fiscal
LSD  - Dietilamina de Ácido Lisérgio
LUS -  Lineamento Universal Superior (Seita)
MAE - Mercado Atacadista de Energia Elétrica
MAM - Museu de Arte Moderna
MAR - Movimento de Ação Revolucionária
MARA - Ministério da Agricultura e Reforma Agrária 
MASP - Museu de Arte de São Paulo
MAST - Movimento dos Agricultores Sem-Terra
MB - Marinha do Brasil
MBA - Master in Business Administration
MBRE - Mercado Brasileiro de Redução de Emissões
MC - Ministério das Comunicações
MCA  - Manual de Crédito Agroindustrial - (BC)
MCB - Movimento Comunista Revolucionário
MCCE -  Movimento de Combate à Corrupção Eleitoral 
MCR  - Manual de Crédito Rural - (BC)
MCT - Ministério da Ciência e Tecnologia
MDB - Movimento Democrático Brasileiro
MDIC - Ministério do Desenvolvimento, Indústria e Comércio
MDL - Mecanismo de Desenvolvimento Limpo 
MDTX - Movimento da Transamazônica e Xingu
ME - Microempresa
MEC - Ministério da Educação e Cultura
MERCOSUL - Mercado Comum do Sul        
MIGA - Agencia Multilateral de Garantia para Investimentos
MIP - Morte, Invalidez Permanente
MJ - Ministério da Justiça
MLST - Movimento de Libertação dos Sem-Terra
MLT - Movimento de Luta pela Terra
MMPD - Movimento do Ministério Público Democrático
MNI  - Manual de Normas e Instruções - (BC)
MNPCT - Mecanismo Nacional de Prevenção e Combate à Tortura
MNR - Movimento Nacionalista Revolucionário 
MODERFROTA - Prog. de Modernização da Frota de Tratores Agríc e Implem Associados e Colheitadeiras
MODERMAQ - Programa de Modernização do Parque Industrial Nacional
MOLIPO - Movimento de Libertação Popular
MONOTRAN - Movimento Nacional de Educação no Trânsito
MP - Ministério do Planejamento, Orçamento e Gestão
MPAS - Ministério da Previdência e Assistência Social
MPE - Ministério Público Estadual
MPF - Ministério Público Federal
MPF - Mandado de Procedimento Fiscal
MPOG - Ministério do Planejamento, Orçamento e Gestão
MPUB - Movimento Popular Unificado de Belém (Pa)
MR-8 - Movimento Revolucionário 8 de Outubro
MRE - Mecanismo de Realocação de Energia
MRM - Movimento Revolucionário Marxista
MRT - Movimento Revolucionário Tiradentes
MS – Ministério da Saúde
MST - Movimento dos Trabalhadores sem-Terra
MSTC - Movimento dos Sem-Teto do Centro
MT - Ministério dos Transportes
MTE - Ministério do Trabalho e Emprego
MTV - Music Television
NBM - Nomenclatura Brasileira de Mercadorias
NBM/SH - Nomenclatura Brasileira de Mercadorias baseada no Sistema Harmonizado
NBT – Norte Brasil Telecom
NCM - Nomenclatura Comum do MERCOSUL  
NDFG - Notificação para Depósito do Fundo de Garantia
NEAD - Núcleo de Estudos Agrários e Desenvolvimento Rural
NIDE - Núcleo de Informações Relativas às Pessoas Portadoras de Deficiência
NIS - Número de Identificação Social 
NOHL - Nuropatia Óptica Hereditária de Leber
NOS  - Operador Nacional do Sistema Elétrico
NPOR - Núcleo de Preparação de Oficias da Reserva (Exército)
NTC - Associação Nacional do Transporte de Cargas
NTI - Núcleo Padagógico Integrado
NTN - Notas do Tesouro Nacional
NTN - I - Notas do Tesouro Nacional, Série I
OAB - Ordem dos Advogados do Brasil
OACI - Organização de Aviação Civil Internacional - agência da ONU
OBAN - Operação Bandeirante
OCB - Organização de Cooperativas do Brasil
OCDE - Organização para Cooperação e Desenvolvimento Econômico
OCM-PO - Organização de Combate Marxista-Leninista - Política Operária
ODM - Objetivos de Desenvolvimento do Milênio
OEA - Organização dos Estados Americanos
OGM - Organismos Geneticamente Modificados 
OIT - Organização Internacional do Trabalho
OLAS - Organização Latino-Americana de Solidariedade
OMC - Organização Mundial do Comércio
OMCI - Organização Marítima Consultiva Intergovernamental
OMPS - Organizações Militares Prestadoras de Serviços
OMS - Organização Mundial de Saúde
ONG - Organização Não Governamental
ONS - Operador Nacional do Sistema Elétrico
ONU - Organização das Nações Unidas
OOC - Operações Oficiais de Crédito
OPAS - Organização Pan-Americana da Saúde no Brasil
ORM - Organização Rômulo Maiorana - Belém - Pa
ORTN - Obrigações Reajustáveis do Tesouro Nacional 
OS - Organizações Sociais
OSCIP - Organizações da Sociedade Civil de Interesse Público
OSCS - Organizações da Sociedade Civil
PA - Pará
PA - PASSAPORTE (Correios)
PAA - Programa de Aquisição de Alimentos
PAC - Programa de Aceleração do Crescimento
PACAL - Projeto Agrocanavieiro Abraham Linconl
PADIS - Programa de Apoio ao Desenvolvimento Tecnológico da Indústria de Semicondutores
PAED - Programa de Complementação ao Atendimento Educacional Especializado às Pessoas Portadoras de Deficiência
PAESE - Plano de Assistência entre Empresas em Situação de Emergência - (SP)
PAN - PARTIDO DOS APOSENTADOS DA NAÇÃO
PAOF - Plano Anual de Outorga Florestal
PARAIBAN - Banco do Estado da Paraíba S.A
PARA-SAR - Esquadrão Aeroterrestre de Salvamento da Força Aérea Brasileira
PARLATINO - Parlamento Latino-Americano 
PAS - Programa de Avaliação Seriada
PAS - Plano Amazônia Sustentável
PASEI - Programa de Apoio Social Especial Integrado
PASEP - Programa de Formação do Patrimônio do Servidor Público
PAT - Programa de Alimentação do Trabalhador
PATVD - Programa de Apoio ao Desenvolvimento Tecnológico da Indústria de Equipamentos para TV Digital
PB - Paraíba
PBCO  - Programa Brasileiro de Eliminação da Produção e do Consumo de Substâncias que Destroem a Camada de Ozônio
PBQP - Programa Brasileiro da Qualidade e Produtividade
PC do B - PARTIDO COMUNISTA DO BRASIL  
PCB - PARTIDO COMUNISTA BRASILEIRO
PCBR - Partido Comunista Brasileiro Revolucionário
PCC - Primeiro Comando da Capital (Grupo criminoso)
PCCHFA - Plano de Carreiras e Cargos do Hospital das Forças Armadas
PCCS - Plano de Carreira, Cargos e Salários
PCCTAE  - Plano de Carreira dos Cargos Técnico-Administrativos em Educação
PCIH - Programa de Controle de Infecções Hospitalares
PCMSO - Programa de Controle Médico de Saúde Ocupacional
PCO - PARTIDO DA CAUSA OPERÁRIA
PCCPREVIC - Plano de Carreiras e Cargos da Previc
PCR - Plano de Comprometimento da Renda 
PCR - Partido Comunista Revolucionário
PCRDA  - Plano de Carreira e Dos Cargos de Reforma e Desenvolvimento Agrário
PCT - Tratado de Cooperação sobre Patentes (Patent Cooperation Treaty)
PCUS - Partido Comunista da União Soviética
PDA - Plano do Desenvolvimento do Assentamento
PDAR - Programa de Desenvolvimento da Aviação Regional 
PDBG - Programa de Despoluição da Baía da Guanabara
PDDE - Programa Dinheiro Direto na Escola
PDG - Programa de Dispêndios Globais
PDRS do Xingu - Plano de Desenvolvimento Regional Sustentável
PDT - PARTIDO DEMOCRÁTICO TRABALHISTA  
PDTA - Programas de Desenvolvimento Tecnológico Agropecuário
PDTI - Programas de Desenvolvimento Tecnológico Industrial
PDV - Programa de Desligamento Voluntário
PE - Pernambuco
PE - Polícia do Exército
PEC - Proposta de Emenda Constitucional
PECC - Plano Especial de Cargos da Cultura
PECOMPE - Pesquisa de Conjuntura das Micro e Pequenas Empresas (Sebrae-SP)
PEHP  - Programa Especial de Habitação Popular
PERFURO - Programa de Erradicação do Trabalho Forçado e do Aliciamento de Trabalhadores 
PES - Plano de Equivalência Salarial 
PES-CP - Plano de Equivalência Salarial  por Categoria Profissional
PET - Programa de Educação Tutorial
PETI - Programa de Erradicação do Trabalho Infantil 
PETROBRÁS - Petróleo Brasileiro S.A
PETROMISA - Petrobrás Mineral S.A.
PETROQUISA - Petrobrás Química S.A.
PF - Polícia Federal
PF - Prato Feito (Restaurante)
PFC - Proposta de Fiscalização e Controle (Câmara dos Deputados)
PFL - PARTIDO DA FRENTE LIBERAL
PGBL - Plano Gerador de Benefícios Livres
PGMQ-SMP - Plano Geral de Metas de Qualidade para o SMP
PGMU  - Plano Geral de Metas para a Universalização do Serviço Telefônico Fixo Comutado Prestado no Regime Público
PGPAF - Programa de Garantia de Preços para a Agricultura Familiar
PGPE - Plano Geral de Cargos do Poder Executivo
PGPM - Política de Garantia de Preços Mínimos 
PHS - PARTIDO HUMANISTA DA SOLIDARIEDADE
PI - Piauí
PIB - Produto Interno Bruto
PID - Permissão Internacional para Dirigir
PIPE - Programa de Inovação Tecnológica em Pequenas Empresas
PIPS - Programa de Incentivo à Implementação de Projetos de Interesse Social
PIS - Programas de Integração Social
PIS/PASEP - Programas de Integração Social e de Formação do Patrimônio do Servidor Público
PL - PARTIDO LIBERAL  
PLAMO -  Plano Nacional de Moradia
PLANALSUCAR - Programa Nacional de Melhoramento da Cana-de-Açúcar
PLANAPIR  - Plano Nacional de Promoção da Igualdade Racial
PLANAPO - Plano Nacional de Agroecologia e Produção Orgânica
PLANASA - Plano Nacional de Saneamento Básico
PLANHAP - Plano Nacional de Habitação Popular
PLANTE - Programa Nacional de Educação e Trabalho
PM - Polícia Militar
PMB – Prefeitura Municipal de Belém – (Pará)
PMCMV - Programa Minha Casa, Minha Vida
PMDB - PARTIDO DO MOVIMENTO DEMOCRÁTICO BRASILEIRO
PMFS - Plano de Manejo Florestal Sustentável
PMN - PARTIDO DA MOBILIZAÇÃO NACIONAL
PNAA - Programa Nacional de Acesso à Alimentação
PNAC - Política Nacional de Aviação Civil
PNAE - Programa Nacional de Alimentação Escolar 
PNAE - Programa Nacional de Atividades Espaciais
PNAES - Programa Nacional de Assistência Estudantil
PNAP - Plano Estratégico Nacional de Áreas Protegidas
PNAPO - Política Nacional de Agroecologia e Produção Orgânica
PNATE - Programa Nacional de Apoio ao Transporte do Escolar
PNATER - Política Nacional de Assistência Técnica e Extensão Rural para a Agricultura Familiar e Reforma Agrária
PNAVSEC - Programa Nacional de Segurança da Aviação Civil Contra Atos de Interferência Ilícita
PNB - Produto Nacional Bruto
PNB - Política Nacional de Biossegurança
PNBE - Pensamento Nacional das Bases Empresariais
PNBE - Programa Nacional Biblioteca na Escola
PNBL - Programa Nacional de Banda Larga
PND - Programa Nacional de Desestatização
PNDH - Programa Nacional de Direitos Humanos
PNDR - Política Nacional de Desenvolvimento Regional
PNETP - Plano Nacional de Enfrentamento ao Tráfico de Pessoas
PNF - Programa Nacional de Florestas
PNGATI - Política Nacional de Gestão Territorial e Ambiental de Terras Indígenas
PNGC - Plano Nacional de Gerenciamento Costeiro
PNHR - Programa Nacional de Habitação Rural
PNHU - Programa Nacional de Habitação Urbana
PNLCC – Programa Nacional de Leite para Crianças Carentes
PNLD - Programa Nacional do Livro Didático
PNLEM - Programa Nacional do Livro Didático para o Ensino Médio
PNMCB - Política Nacional de Incentivo ao Manejo Sustentado e ao Cultivo do Bambu
PNMPO - Programa Nacional de Microcrédito Produtivo Orientado
PNMT - Plano Nacional de Municipalização do Turismo
PNOT - Política Nacional de Ordenamento Territorial
PNP - Programa Nacional de Publicização
PNPCT - Política Nacional de Desenvolvimento Sustentável dos Povos e Comunidades Tradicionais
PNPDDH - Política Nacional de Proteção aos Defensores dos Direitos Humanos
PNPE - Programa Nacional de Estímulo ao Primeiro Emprego para os Jovens
PNPM - Plano Nacional de Políticas para as Mulheres 
PNRM - Política Nacional para os Recursos do Mar
PNSA - Política Nacional de Saneamento Ambiental 
PNSB - Plano Nacional de Saneamento Básico
PNSB - Política Nacional de Segurança de Barragens
PNSST - Política Nacional de Segurança e Saúde no Trabalho
PNTS - Programa Nacional de Treinamento do Servidor Público
PNUD - Programa das Nações Unidas para o Desenvolvimento
POC - Partido Operário Comunista
POF - Pesquisa de Orçamento Familiar
POLOP - Organização Revolucionária Marxista - Política Operária
PORT - Partido Operário Revolucionário Trotskista
PORTOBRÁS - Empresa de Portos do Brasil S.A.
POUPEX - Associação de Poupança e Empréstimo
PP - PARTIDO PROGRESSISTA
PPA - Plano Plurianual
PPB - Processo Produtivo Básico
PPCAAM  - Programa de Proteção a Crianças e Adolescentes Ameaçados de Morte
PPCDAM  - Plano de Prevenção e Controle do Desmatamento na Amazônia Legal
PPE - Parcela de Preço Específica 
PPG7 – Programa Piloto de Proteção às Florestas Tropicais do Brasil
PPI - Projeto Piloto de Investimentos Públicos
PPRA - Programa de Prevenção de Riscos Ambientais
PPS - PARTIDO POPULAR SOCIALISTA- (ANTIGO PCB)
PPT - Programa Prioritário de Termeletricidade
PR - Paraná
PR - REEMBOLSO POSTAL - CLIENTE AVULSO (Correios)
PRA - Programa de Regularização Ambiental
PRECONVE - Programa de Poluição de Ar por Veículos Automotores
PREVHAB - Associação de Previdência dos Empregados do extinto BNH
PREVI  - Caixa de Previdência dos Funcionários do Banco do Brasil
PREVIC - Superintendência Nacional de Previdência Complementar
PRF - Polícia Rodoviária Federal
PRISE - Programa de Ingresso Seriado
PROAGRO - Programa de Garantia da Atividade Agropecuária
PROAME - Programa de Aleitamento Materno Exclusivo (Pa) 
PROAP  - Programa de Administração Patrimonial Imobiliário da União
PROBE - Programa Biblioteca Eletrônica
PROCARGAS - Programa de Apoio ao Desenvolvimento do Transporte de Cargas Nacional
PROCEL - Programa Nacional de Conservação de Energia Elétrica
PROCERA - Programa Especial de Crédito para a Reforma Agrária 
PROCON - Serviço de Proteção ao Consumidor
PROAP - Programa de Administração Patrimonial Imobiliário da União 
PRODAV - Programa de Apoio ao Desenvolvimento do Audiovisual Brasileiro
PRODEA - Programa de Distribuição Emergencial de Alimentos
PRODECER - Programa de Cooperação Nipo-Brasileiro para o Desenvolvimento dos Cerrados
PRODECER-II - Programa de Desenvolvimento dos Cerrados 
PRODECINE - Programa de Apoio ao Desenvolvimento do Cinema Nacional
PRODIN - Programa de Orientação e Defesa do Investidor
PRODEEM - Programa de Desenvolvimento Energético dos Estados e Municípios
PROECTA -  Programa de Capacitação pelo Trabalho (Pará)
PROEJA  - Programa de Integração da Educação Profissional ao Ensino Médio na Modalidade de Educação de Jovens e Adultos
PROEXT - Programa de Extensão Universitária
PROFAE - Projeto de Profissionalização dos Trabalhadores de Enfermagem
PROGER - Programa de Geração de Emprego e Renda
PROFROTA PESQUEIRA - Programa Nacional de Financiamento da Ampliação e Modernização da Frota Pesqueira Nacional
PROFUT - Programa de Modernização da Gestão e de Responsabilidade Fiscal do Futebol Brasileiro
PROGER RURAL FAMILIA - Programa de Geração de Emprego e Renda Rural Familiar
PROINFA -Programa de Incentivo às Fontes Alternativas de Energia Elétrica
PRÓ-JOVEM - Programa Nacional de Inclusão de Jovens
PROINFO - Programa Nacional de Tecnologia Educacional
PRÓ-INFRA - Programa de Apoio ao Desenvolvimento da Infra-Estrutura do Cinema e do Audiovisual
PRÓ-LEITURA - Fundação Nacional Pró-Leitura
PROLER - Programa Nacional de Incentivo à Leitura
PROMASP - Programa de Modernização, Agilização, Aprimoramento e Segurança da Fiscaliz. do Tráfego Internacional e do Passaporte Brasileiro
PRÓ-MEMÓRIA - Fundação Nacional Pró-Memória 
PROMINP - Programa de Mobilização da Indústria Nacional de Petróleo e Gás Natural
PROMOEX - Programa de Modernização do Sistema de Controle Externo dos Estados e Municípios
PRONA - PARTIDO DE REEDIFICAÇÃO DA ORDEM NACIONAL
PRONAC - Programa Nacional de Apoio à Cultura
PRONABIO - Programa Nacional da Diversidade Biológica
PRONACOOP SOCIAL  - Programa Nacional de Apoio ao Associativismo e Cooperativismo Social
PRONAF - Programa Nacional de Fortalecimento da Agricultura Familiar
PRONAICA - Programa Nacional de Atenção Integral à Criança e ao Adolescente
PRONASCI  - Programa Nacional de Segurança Pública com Cidadania
PRONAS/PCD - Programa Nacional de Apoio à Atenção da Saúde da Pessoa com Deficiência
PrONATEC - Programa Nacional de Acesso ao Ensino Técnico e Emprego
PRONATER - Programa Nacional de Assistência Técnica e Extensão Rural na Agricultura Familiar e na Reforma Agrária
PRONERA. - Programa Nacional de Educação na Reforma Agrária
PRONINC - Programa Nacional de Incubadoras de Cooperativas Populares
PRONON - Programa Nacional de Apoio à Atenção Oncológica
PRORELIT - Programa de Redução de Litígios Tributários
PRORURAL - Programa de Assistência ao Trabalhador Rural
PRO-REG - Programa de Fortalecimento da Capacidade Institucional para Gestão em Regulação
PROSECA - Programa Permanente de Combate à Seca 
PROSEGE - Programa de Ação Social em Saneamento 
PROSOFT - Programa para o Desenvolvimento da Indústria Nacional de Software e Serviços Correlatos
PROSUS - Programa de Fortalecimento das Entidades Privadas Filantrópicas e das Entidades sem Fins Lucrativos que Atuam na Área da Saúde e que Participam de Forma .....................Complementar do Sistema Único de Saúde
PROTECH - Programa de Difusão Tecnológica para Construção de Habitação de Baixo Custo
PROTEJO - Projeto de Proteção de Jovens em Território Vulnerável
ProTIC - Programa de Apoio à Pesquisa, Desenvolvimento e Inovação em Tecnologias Digitais de Informação e Comunicação
PROUCA - PROGRAMA UM COMPUTADOR POR ALUNO – 
PROUNI - Programa Universidade para Todos
PRODAV - Programa de Apoio ao Desenvolvimento do Audiovisual Brasileiro
PRP - PARTIDO REPUBLICANO PROGRESSISTA
PRTB - PARTIDO RENOVADOR TRABALHISTA BRASILEIRO  
PSB - PARTIDO SOCIALISTA BRASILEIRO  
PSC - PARTIDO SOCIAL CRISTÃO  
PSD - Partido Social Democrático
PSDB - PARTIDO DA SOCIAL DEMOCRACIA BRASILEIRA  
PSDC- PARTIDO SOCIAL DEMOCRATA CRISTÃO  
PSE - Programa Saúde na Escola
PSH - Programa de Subsídio à Habitação de Interesse Social
PSL - PARTIDO SOCIAL LIBERAL
PSRM - Plano Setorial para os Recursos do Mar
PSTU- PARTIDO SOCIALISTA DOS TRABALHADORES UNIFICADO
PT - PARTIDO DOS TRABALHADORES  
PT do B - PARTIDO TRABALHISTA DO BRASIL
PTB - PARTIDO TRABALHISTA BRASILEIRO  
PTC - PARTIDO TRABALHISTA CRISTÃO (ANTIGO PRN)  
PTN - PARTIDO TRABALHISTA NACIONAL  
PUC -  Pontifícia Universidade Católica
PUCRCE - Plano Único de Classificação e Retribuição de Cargos e Empregos
PV -  PARTIDO VERDE
QG - Quartel-General
QOEA - Quadro de Oficiais Especialistas da Aeronáutica
QOPM  - Quadro de Oficiais Policiais Militares - LEI Nº 12.086/06.11.2009
QOPMS - Quadro de Oficiais Policiais Militares de Saúde
QOPMC - Quadro de Oficiais Policiais Militares Capelães
QOPMA - Quadro de Oficiais Policiais Militares Administrativos
QOPME - Quadro de Oficiais Policiais Militares Especialistas
QOPMM - Quadro de Oficiais Policiais Militares Músicos
QPPMC - Quadro de Praças Policiais Militares Combatentes
QPPME - Quadro de Praças Policiais Militares Especialistas
RADIOBRÁS – Empresa Brasileira de Comunicação S.A
RAE - Regulamento de Administração do Exército
RAIS - Relação Anual de Informações Sociais
RAROC - Retorno Ajustado ao Risco sobre Capital
RASEAM - Relatório Anual Socioeconômico da Mulher
RAV - Retribuição Adicional Variável
RBJID - Representação do Brasil na Junta Interamericana de Defesa
RBMLQ - Rede Brasileira de Metrologia Legal e Qualidade
RBT - Rede Brasil de Tecnologia 
RC - CARTA REGISTRADA COM VALOR DECLARADO (Correios)
RCPGAER - Regulamento do Corpo do Pessoal Graduado da Aeronáutica
RDC - Regime Diferenciado de Contratações Públicas
RDD - Regime Disciplinar Diferenciado ( Penitenciárias)
RECAP  - Regime Especial de Aquisição de Bens de Capital para Empresas Exportadoras
RecMec - Regimento de Reconhecimento Mecanizado
RECAP  - Regime Especial de Aquisição de Bens de Capital para Empresas Exportadoras
RECOM - Regime Especial de Tributação para construção, ampliação, reforma ou modernização de estádios de futebol
RECOMPE - Regime Especial para Aquisição de Computadores para Uso Educacional
RECOOP - Programa de Revitalização de Cooperativas de Produção Agropecuária
RECOPA - Regime Especial de Tributação para Construção, Ampliação, Reforma ou Modernização de Estádios de Futebol
RDC - Regime Diferenciado de Contratações Públicas 
RE - REGISTRADO ECONÔMICO (Correios)
REB - Registro Especial Brasileiro
REDE - Resistência Nacional Democrática Popular 
REDE INFOSEG - Rede de Integração Nacional de Informações de Segurança Pública, Justiça e Fiscalização
REDESIM  - Rede Nacional para a Simplificação do Registro e da Legalização de Empresas e Negócios
RENAESP - Rede Nacional de Espcialização em Segurança Pública
REFIS - Programa de Recuperação Fiscal
REFORSUS  -  Rede de Serviços do Sistema Único de Saúde
REHUF - Programa Nacional de Reestruturação dos Hospitais Universitários Federais
REIF - Regime Especial de Incentivo ao Desenvolvimento da Infraestrutura da Indústria de Fertilizantes
REINTEGRA - Regime Especial de Reintegração de Valores Tributários para as Empresas Exportadoras
RENACH - Registro Nacional de Condutores Habilitados
RGE - Reserva Global de Reversão
RENACOM - Registro Nacional de Compensação de Multas (Trânsito)
RENAINF - Registro Nacional de Infrações (Trânsito)
RENAVAM - Registro Nacional de Veículos Automotores
REPENEC - Regime Especial de Incentivos para o Desenvolvimento de Infraestrutura da Indústria Petrolífera nas Regiões Norte, Nordeste e Centro-Oeste 
REPES  - Regime Especial de Tributação para a Plataforma de Exportação de Serviços de Tecnologia da Informação
REPETRO - Regime Aduaneiro Especial de Exportação e de Importação de Bens destinados às atividades de Pesquisa e de Lavra das Jazidas de Petróleo e de Gás Natura
REPORTO - Regime Tributário para Incentivo à Modernização e Ampliação da Estrutura Portuária
RETAERO - Regime Especial para a Indústria Aeronáutica Brasileira
REUNI - Reestruturação e Expansão das Universidades Federais
RF - OBJETO DA RECEITA FEDERAL (Correios)
RF - Receita Federal
RFFSA - Rede Ferroviária Federal S.A.
RGE - Reserva Global de Reversão
RGPS - Regimento Geral de Previdência Social
RGR - Reserva Global de Reversão
RI - Regimento de Infantaria
RI - Registrado Prioritário (Correios)
RIDE - Região Integrada de Desenvolvimento do Distrito Federal e Entorno 
RIMA - Relatório de Impacto Ambiental
RIPI  - Regulamento do Imposto sobre Produtos Industrializados 
RISAER - Regulamento Interno dos Serviços da Aeronáutica
RJ - Rio de Janeiro
RL - Registrado Lógico (Correios)
RLR - Receita Líquida Real
RN - Rio Grande do Norte
RNP  - Rede Nacional de Pesquisa
RNPI - Relação Nacional de Pessoas Impedidas de Operar com os Fundos e Programas Habitacionais e com o Sistema Financeiro da Habitação
RNTR-C - Registro Nacional de Transportadores Rodoviários de Cargas
ROF - Registro de Operações Financeiras
RP - Reembolso Postal - Cliente Inscrito (Correios)
RPPN  - Reserva Particular do Patrimônio Natural
RPS - Regulamento da Previdência Social
RR - Carta Registrada Sem Valor Declarado (Correios)
RS - Rio Grande do Sul
RTVE - Fundação Rádio e Televisão Educativa e Cultural
RVCVM - Retribuição Variável da Comissão de Valores Mobiliários 
RVSUSEP  - Retribuição Variável da Superintendência de Seguros Privados
SAC - Secretaria de Aviação Civil da Presidência da República
SAEB - Sistema Nacional de Avaliação do Ensino Básico
SAF - Secretaria da Administração Federal
SAGRI  - Secretaria Executiva de Agricultura
SAMU - Serviço de Atendimento Móvel de Urgência
SAP - Sistema de Automação de Processos
SAPS - Serviço de Alimentação da Previdência Social
SARFA - Serviço de Assistência Religiosa nas Forças Armadas
SASF - Sistema de Assessoramento para Assuntos Federativos SASSE - Serviço de Assistência e Seguro Social dos Economiários 
SASSE - Companhia Nacional de Seguros Gerais
SAVA - Superintendência de Abastecimento do Vale Amazônico
SAT  - Seguro Acidente de Trabalho
S. At. - Serviço Atuarial (Previdência Social)SBCP – Sociedade Brasileira de Cirurgia Plástica
SBCTA – Sociedade Brasileira  de Ciência e Tecnologia de Alimentos
SBDE - Sistema Brasileiro de Defesa da Concorrência
SBEA - SOCIEDADE BRASILEIRA DE ENGENHARIA AGRÍCOLA
SBEF - Sociedade Brasileira de Engenheiros Florestais
SBMET - SOCIEDADE BRASILEIRA DE METEOROLOGIA
SBPC - Sociedade Brasileira para o Progresso da Ciência
SBR - Sociedade Brasileira de Reumatologia
SBT - Sistema Brasileiro de Televisão
SBTVD - Sistema Brasileiro de Televisão Digital
SBTVD-T  - Sistema Brasileiro de Televisão Digital Terrestre 
SC - SEDEX A COBRAR (Correios)
SCAP - Sistema de Controle de Administração Portuária
SCE - Seguro de Crédito à Exportação 
SCIP - Sociedade Dos Profissionais De Inteligência Competitiva (Inglês)
SCJS - Sistema Nacional Do Comércio Justo E Solidário
SCM - Sociedades De Crédito Ao Microempreendedor
SDE - Secretaria  de Direito Econômico
SDR - Secretaria Do Desenvolvimento Regional 
SDS - Social-Democracia Sindical 
SDU - Secretaria de Desenvolvimento Urbano
SE - ENCOMENDA SEDEX (Correios)
SEAE  - Secretaria De Assuntos Econômicos
SEAP - Secretaria Especial De Aqüicultura E Pesca
SEAS - Secretaria de Estado de Assistência Social  ( Pará)
SEBRAE - Serviço Nacional de Apoio Às Micro E Pequenas Empresas 
SECEX - Secretaria de Comércio Exterior
SECOM/SG-PR - Subsecretaria de Comunicação Institucional da Secretaria-Geral
SECONSIPAM - Secretaria-Executiva do Conselho Deliberativo do Sistema de Proteção da Amazônia
SECTAM - Secretaria Executiva De Ciência, Tecnologia E Meio Ambiente - (Pará)
SEDH - Secretaria Especial Dos Direitos Humanos (Presidência Da República))
SEDU - Secretaria Especial de Desenvolvimento Urbano
SEDUC - Secretaria Executiva De Estado De Educação
SEFIT - Secretaria De Fiscalização Do Trabalho
SELIC - Sistema Especial de Liquidação e de Custódia
SEMA - Secretaria Especial do Meio Ambiente
SEMTA - Serviço Especializado da Mobilização de Trabalhadores para a Amazônia
SEMTEC - Secretaria de Educação Média e Tecnológica
SEN - Sistema de Ensino Naval
SENAC - Serviço Nacional de Aprendizagem Comercial 
SENAD - Secretaria Nacional Antidrogas
SENAI - Serviço Nacional de Aprendizagem Industrial
SENAR - Serviço Nacional de Aprendizagem Rural
SENASP - Secretaria Nacional de Segurança Pública (MJ)
SENAT - Serviço Nacional de Aprendizagem do Transporte
SEPIN - Secretaria de Política de Informática (MCT)
SEPLAN - Secretaria de Planejamento
SEPPIR - Secretaria Especial de Políticas de Promoção da Igualdade Racial
SERASA - Centralização dos Serviços dos Bancos S.A.
SERES - Secretaria de Regulação e Supervisão da Educação Superior
SERPRO -  Serviço Federal de Processamento de Dados 
SERT - Secretaria do Emprego e Relações do Trabalho
SESC - Serviço Social do Comércio
SESCOOP - Serviço Nacional de Aprendizagem do Cooperativismo
SESI - Serviço Social da Indústria 
SESMA - Secretaria Municipal de Saúde (Belém -Pa)
SESPA - Secretaria de Saúde Estadual (Pa)
SEST - Serviço Social do Transporte
SETEPS - Secretaria Executiva de Trabalho e Proteção Social
SFB - Serviço Florestal Brasileiro
SFC -Sistema Federal de Cultura
SFH - Sistema Financeiro da Habitação
SFICI - Serviço Federal de Informações e Contra-Informações
SFS - Sistema Financeiro do Saneamento
SFV - Sistema Federal de Viação 
SGDC - Satélite Geoestacionário de Defesa e Comunicações Estratégicas
SGPC - Sistema Global de Preferências Comerciais entre Países em Desenvolvimento
SI - SEDEX VIP (Correios)
SIAL - Sistema de Acompanhamento Legislativo
SIAFEM  - Sistema Integrado de Administração Financeira para Estados e Municípios
SIAFI -Sistema Integrado de Administração Financeira (Governo Federal)
SIAPE - Sistema Integrado de Administração de Pessoal
SIAPE - Sistema Integrado de Administração de Recursos Humanos
SIASG - Sistema Integrado de Administração de Serviços Gerais
SIBRATEC - Sistema Brasileiro de Tecnologia
SIC – Serviço de Informação ao Cliente
SICAF - Sistema de Cadastramento Unificado de Fornecedores
SIDA/AIDS - Síndrome da Imunodeficiência Adquirida 
SIDERAMA - Companhia Siderúrgica da Amazônia
SIDERBRAS - Siderurgia Brasileira S.A 
SIDOF - Sistema de Geração e Tramitação de Documentos Oficiais
SIDOR - Sistema Integrado de Dados Orçamentários
SIEST - Sistema de Informação das Estatais
SIGA - Gestão de Documentos de Arquivo
SIGESPE - Sistema de Gestão de Pessoas - TJE/PA
SIGPLAN - Sistema de Informações Gerenciais e de Planejamento do Plano Plurianual
SII – Síndrome do Intestino Irritável
SIMPaz - Sistema Nacional das Mulheres da Paz
SIMPLES - Sistema Integrado de Pagamento de Impostos e Contribuições das Microempresas e Empresas de Pequeno Porte
SIN - Sistema Interligado Nacional
SINAC - Sistema Nacional de Centrais de Abastecimento
SINAES  - Sistema Nacional de Avaliação da Educação Superior
SINAJUVE - Sistema Nacional de Juventude
SINAL - Sindicato Nacional dos Funcionários do Banco Central
SINAMOB - Sistema Nacional de Mobilização
SINAPAD  - Sistema Nacional de Processamento de Alto Desempenho
SINAPIR - Sistema Nacional de Promoção da Igualdade Racial
SINAR - Sistema Nacional de Arquivos
SINARM - Sistema Nacional de Armas
SINASAN - Sistema Nacional de Sangue, Componentes e Derivados
SINASEMPU - Sindicato Nacional dos Servidores do Ministério Público da União
SINDAPP  - Sindicato das Entidades de Previdência Complementar
SINDEC - Sistema Nacional de Defesa Civil 
SINDEC - Sistema de Informação e Apoio à Tomada de Decisão
SINDEMVÍDEO - Sindicato das Empresas Videolocadoras do Estado de São Paulo
SINDSEMPPE - Sindicato dos Servidores do Ministério Público de Pernambuco
SINJEP - Sindicato dos Trabalhadores do Judiciário do Pará
SINE - Sistema Nacional de Emprego
SINELEPA - Sindicato dos Empresários Lotéricos dos Estados do Pará e Amapá
SINESP - Sistema Nacional de Informações de Segurança Pública, Prisionais e sobre Drogas 
SINIMA - Sistema Nacional de Informação sobre Meio Ambiente
SINISA - Sistema Nacional de Informações em Saneamento Básico
SINPAS  - Sistema Nacional de Previdência e Assistência Social
SINPI - Sistema Nacional de Procurados e Impedidos (Polícia Federal)
SINPRO - Sindicato dos Professores da Rede Particular de Ensino - (Pará)
SINTEP - Sindicado dos Servidores Públicos
SINTESE - Sistema Integrado de Tratamento Estatístico de Séries Estratégicas
SIORG - Organização e Inovação Institucional do Governo Federal
SIPAER - Sistema de Investigação e Prevenção de Acidentes Aeronáuticos
SIPAM - Sistema de Proteção da Amazônia
SIPEC - Sistema de Pessoal Civil da Administração Federal 
SIPRA - Sistema de Informação do Programa de Reforma Agrária
SIRC - Sistema Nacional de Informações de Registro Civil
SIPRON - Proteção ao Programa Nuclear Brasileiro
SISAN - Sistema Nacional de Segurança Alimentar e Nutricional
SISBB - Sistema de Informações Banco do Brasil
SISCOMEX - Sistema Integrado de Comércio Exterior
SISFOR - Sistema Nacional do Bolsa-Formação
SISCFORT - Sistema de Controle de Remanejamento e Reserva Técnica
SISG - Sistema de Serviços Gerais
SISNAD - Sistema Nacional de Políticas Públicas sobre Drogas
SISNAMA - Sistema Nacional do Meio Ambiente 
SISNI - Sistema Nacional de Informações
SISOBI - Sistema Informatizado de Controle de Óbitos 
SISOSP - Sistema Integrado de Saúde Ocupacional do Servidor Público Federal
SISP - Sistema de Administração dos Recursos de Informação e Informática
SisPAC - Sistema de Monitoramento do Programa de Aceleração do Crescimento
SISTENS - Sistema de Ensino da Aeronáutica
SL - SEDEX LÓGICO (Correios)
SM - SEDEX MESMO DIA (Correios)
SMC - Serviço Móvel Celular
SML - Sistema de Pagamentos em Moedas Locais
SMP - Serviço Móvel Pessoal
SN - SEDEX COM VALOR DECLARADO (Correios)
SNCR - Sistema Nacional de Crédito Rural
SNCTI - Sistema Nacional de Ciência, Tecnologia e Inovação
SNEA - Sindicato Nacional das Empresas Aéreas
SNG - Sistema Nacional de Gravame
SNHIS - Sistema Nacional de Habitação de Interesse Social
SNI - Serviço Nacional de Informações
SNISB - Sistema Nacional de Informações sobre Segurança de Barragens
SNPA - Sistema Nacional de Pesquisa Agropecuária 
SNPCT - Sistema Nacional de Prevenção de Combate à Tortura
SNT - Sistema Nacional de Trânsito
SNUC - Sistema Nacional de Unidades de Conservação da Natureza 
SNV - Sistema Nacional de Viação
SOBEET - Sociedade Brasileira de Estudos de Empresas Transacionais e da Globalização Econômica
SOBES - SOCIEDADE  BRASILEIRA DE ENGENHARIA DE SEGURANÇA
SOC - Sociedade  de Orientação e Cultura
SOLAS - Salvaguarda da Vida Humana no Mar
SOMA - Sociedade Operadora do Mercado de Ativos
SOS -  Serviço de Obras Sociais 
SOS - Save our souls - Salvem nossas almas - expressão inglesa
SPB - Sistema de Pagamentos Brasileiro
SPC - Serviço de Proteção ao Consumidor
SPC - Secretaria de Previdência Complementar
SPE - Secretaria de Política Econômica
SPED - Sistema Público de Escrituração Digital
SPHAN - Secretaria do Patrimônio Histórico e Artístico Nacional 
SPI -   Serviço de Proteção ao Índio
SPM - Secretaria Especial de Políticas para as Mulheres
SR - SEDEX (Correios)
SRAG - Síndrome Respiratória Aguda Grave (Pneumonia Asiática)
SRF - Secretaria da Receita Federal
SRI - Secretaria de Relações Institucionais
SS - SEDEX FÍSICO (Correios)
STF - Supremo Tribunal Federal
STFC - Serviço Telefônico Fixo Comutado
STJ - Superior Tribunal de Justiça
STJD - Superior Tribunal de Justiça Desportiva
STM - Superior Tribunal Militar
SUAS  - Sistema Único de Assistência Social 
SUCAM - Superintendências de Campanhas de Saúde Pública
SUDAM - Superintendência do Desenvolvimento da Amazônia
SUDECO - Superintendência do Desenvolvimento da Região Centro-Oeste
SUDENE - Superintendência do Desenvolvimento do Nordeste
SUDEPE - Superintendência do Desenvolvimento da Pesca
SUDESUL - Superintendência do Desenvolvimento da Região Sul 
SUFRAMA  - Superintendência da Zona Franca de Manaus
SUIPA - Sociedade União Internacional Protetora dos Animais
SUNAB - Superintendência Nacional de Abastecimento
SUNAMAN  - Superintendência Nacional da Marinha Mercante
SURSAN - Superintendência de Urbanização e Saneamento  
SUS - Sistema Único de Saúde
SUSEP - Superintendência de Seguros Privados
SUSIPE - Superintendência do Sistema PenalTAC - Transportador Autônomo de Cargas
TAFIC - Taxa de Fiscalização e Controle da Previdência Complementar
TBF - Taxa Básica Financeira
TC - Terceiro Comando (Criminosos)
TCE - Tribunal de Contas do Estado
TCFA - Taxa de Controle e Fiscalização Ambiental
TCM - Tribunal de Contas do Município
TCO - Termo Circunstanciado de Ocorrência
TCO - Tele Centro Oeste
TCU - Tribunal de Contas da União
TDA - Título da Dívida Agrária
TEC - Tarifa Externa Comum, do Mercosul
TECPAR - Instituto de Tecnologia do Paraná
TED  - Transferência Eletrônica Disponível
TELCOMP - Associação Brasileira das Prestdoras de Serviços de Telecomunicações Competitivas
TELEBRÁS - Telecomunicações Brasileiras S.A.
TELESP - Telecomunicações de São Paulo S.A.
TELEVISÃO - Serviço de Radiodifusão de Sons e Imagens
TERRACAP - Companhia Imobiliária de Brasília
TFD - Tratamento Fora de Domicílio
TFPC - Taxa de Fiscalização dos Produtos Controlados pelo Exército Brasileiro
TFR - Tribunal Federal de Recursos
TFSE - Taxa de Fiscalização do Sistema Elétrico
TIM  - Telecom Italia Mobile
TIPI - Tabela de Incidência do Imposto sobre Produtos Industrializados
TJ - Tribunal de Justiça
TJLP - Taxa de Juros de Longo Prazo
TLGE - Transferência Líquida dos Governos Estaduais
TLP - Taxa de Iluminação Pública
TOC - Transtorno Obsessivo Compulsivo
TPI - Tribunal Penal Internacional
TPM - Tensão Pré-Menstrual
TR - Taxa Referencial 
TRE - Tribunal Regional Eleitoral
TRENSURB - Empresa de Trens Urbanos de Porto Alegre S.A
TRF - Tribunal Regional Federal
TRT  - Tribunal Regional do Trabalho
TSA - Taxa de Serviços Administrativos 
TSB - Transportadora Sulbrasileira de Gás S.A
TST - Tribunal Superior do Trabalho
TUPs - Telefones de Uso Público
TUST - Tarifas de Uso do Sistema de Transmissão
TVA - Televisão por Assinatura
UAB - Universidade Aberta do Brasil
UBP - Uso de Bem Público
UBC  - União Brasileira de Cegos
UBES - União Brasileira de Estudantes Secundaristas
UDN - União Democrática Nacional
UDR - União Democrática Ruralista
UE - União Européia
UEPA - Universidade do Estado do Pará
UFABC - Fundação Universidade Federal do ABC
UFC - Universidade Federal do Ceará
UFCA - Universidade Federal do Cariri
UFCSPA - Fundação Universidade Federal de Ciências da Saúde de Porto Alegre
UFG - Universidade Federal de Goiás
UFIR- Unidade Fiscal de Referência
UFMG - Universidade Federal de Minas Gerais
UFOB - Universidade Federal do Oeste da Bahia
UFPa - Universidade Federal do Pará
UFPEL - Universidade Federal de Pelotas
UFRJ - Universidade Federal do Rio de Janeiro
UFScar - Universidade Federal de São Carlos/SP
UFRGS - Universidade Federal do Rio Grande do Sul
UFRR - Universidade Federal de Roraima
UFVJM - Universidade Federal dos Vales do Jequitinhonha e Mucuri
UIM - União Internacional de Magistrados
ULBRA - Universidade Luterana do Brasil
UMNR - Serviço de Supervisão de Menores
UNAFISCO  - Sindicato Nacional dos Auditores Fiscais da Receita Federal
UNAJ - Unidade de Arrecadação Judiciária - TJE/PA
UNAMA  - Universidade da Amazônia 
UNAMIBB - União Nacional dos Acionistas Minoritários do Banco do Brasil
UNB - Universidade de Brasília
UNDIME - União Nacional dos Dirigentes Municipais de Educação
UNE - União Nacional dos Estudantes
UNED - Unidades de Ensino Descentralizadas
UNESCO - Organização das Nações Unidas para a Educação, a Ciência e a Cultura
UNESP - Universidade Estadual Paulista
UNICAFES - União Nacional de Cooperativas da Agricultura Familiar e Economia Solidária
UNICAMP - Universidade Estadual de Campinas
UNICEF - Fundo das Nações Unidas para a Infância
UNIDAS - União Nacional das Instituições de Autogestão em Saúde
UNIDROIT - Instituto Internacional para a Unificação do Direito Privado
UNIFESP - Universidade Federal de São Paulo
UNIFESSPA - Universidade Federal do Sul e Sudeste do Pará
UNILA - Universidade Federal da Integração Latino-Americana
UNIPAMPA - Fundação Universidade Federal do Pampa
UNIRIO  - Universidade do Rio de Janeiro
UNISOL - União e Solidariedade das Cooperativas e Empreendimentos de Economia Social do Brasil
UNISUL - Universidade do Sul de Santa Catarina
UNITA - União para a Independência Total de Angola
UNITRABALHO - Fundação Interuniversitária de Estudos e Pesquisas sobre o Trabalho
UPC - Unidade Padrão de Capital
UPF -  Unidade Padrão de Financiamento
URFA - Universidade Rural da Amazônia
URV - Unidade Real de Valor
USP - Universidade de São Paulo
UTI - Unidade de Terapia Intensiva
VALEC – Engenharia, Construções e Ferrovias S.A
VAR - Valor em Risco
VAR - Vanguarda Armada Revolucionária 
VARIG - Viação Aérea Rio-Grandense
VASP - Viação Aérea São Paulo S.A
VCP-ATS - Valor em Caráter Pessoal do Adicional por Tempo de Serviço Incorporado (BB)
VCP-VP - Valor em Caráter Pessoal do VP (BB)
VGBL - Vida Gerador de Benefícios Livres
VP - Vencimento Padrão (BB)
VPE - Vantagem Pecuniária Especial  -  (Polícia Militar-DF)
VPNI - Vantagens pessoais nominalmente identificadas
VPR - Vanguarda Popular Revolucionária
VR - Valor de Referência (VR)
VTN - Valor da Terra Nua
VTNt  - Valor da Terra Nua Tributável
ZDI - Zona de Defesa Interna
ZEE - Zoneamento Ecológico-Econômico
ZEEZOC - Zoneamento Ecológico-Econômico da Zona Costeira
ZEIS - Zona Especial de Interesse Social